term,crn,Seats_Capacity,Seats_Actual,Seats_Remaining,Waitlist_Capacity,Waitlist_Actual,Waitlist_Remaining
202501,22140,5,1,4,5,0,5
202501,23471,27,26,1,100,0,100
202501,22927,80,80,0,100,9,91
202409,13101,60,60,0,100,0,100
202409,13612,27,26,1,100,0,100
202501,23918,35,0,35,0,0,0
202409,12787,200,184,16,100,0,100
202409,10727,30,26,4,0,0,0
202409,10304,24,24,0,4,0,4
202409,12203,22,19,3,20,0,20
202501,23096,75,28,47,100,0,100
202409,13255,45,37,8,100,0,100
202501,21157,32,32,0,30,0,30
202409,13297,45,30,15,100,0,100
202409,12146,15,15,0,20,0,20
202409,10762,21,20,1,0,0,0
202409,10797,17,16,1,0,0,0
202409,13588,18,17,1,100,0,100
202501,22773,25,25,0,100,25,75
202409,10500,150,92,58,100,0,100
202409,13848,13,6,7,0,0,0
202409,10661,56,44,12,10,0,10
202409,12584,35,26,9,30,0,30
202501,20587,100,56,44,80,0,80
202501,21225,33,33,0,100,7,93
202409,12394,3,0,3,3,0,3
202409,10412,15,10,5,10,0,10
202409,11513,43,30,13,50,0,50
202501,21205,40,40,0,5,5,0
202409,12860,20,26,-6,100,0,100
202409,12937,100,100,0,100,0,100
202409,12675,24,23,1,0,0,0
202501,20819,15,15,0,20,0,20
202409,10688,60,47,13,10,0,10
202501,21557,22,15,7,0,0,0
202409,12279,5,0,5,5,0,5
202501,20199,32,32,0,100,22,78
202501,22956,38,38,0,50,26,24
202501,21359,18,18,0,5,4,1
202501,21914,40,40,0,40,13,27
202409,11919,40,40,0,15,0,15
202501,21628,20,9,11,20,0,20
202409,13913,90,92,-2,100,0,100
202501,20614,64,67,-3,10,0,10
202501,22658,20,20,0,2,0,2
202501,20455,30,29,1,4,2,2
202501,20165,18,18,0,0,0,0
202501,21336,30,7,23,100,0,100
202501,20314,20,20,0,2,2,0
202409,12384,5,3,2,5,0,5
202501,21242,23,23,0,23,15,8
202409,11781,25,15,10,100,0,100
202409,11693,22,19,3,0,0,0
202501,23511,6,1,5,6,0,6
202409,12599,60,21,39,100,0,100
202409,12840,20,11,9,0,0,0
202409,12819,20,13,7,2,0,2
202501,20181,13,13,0,0,0,0
202409,12169,90,90,0,20,0,20
202501,22149,30,10,20,100,0,100
202409,12095,50,50,0,25,0,25
202409,11985,20,10,10,100,0,100
202409,14008,54,51,3,100,0,100
202409,11301,3,2,1,3,0,3
202501,21200,40,40,0,5,1,4
202501,22734,35,35,0,0,0,0
202501,20691,30,29,1,0,0,0
202501,22602,12,3,9,100,0,100
202409,13260,75,32,43,100,0,100
202409,12721,24,21,3,0,0,0
202409,10113,22,22,0,100,0,100
202501,20539,18,17,1,3,0,3
202409,11987,101,87,14,100,0,100
202409,10839,13,9,4,0,0,0
202409,13267,16,14,2,100,0,100
202409,14052,2,2,0,0,0,0
202409,11465,198,202,-4,100,0,100
202501,21947,60,48,12,35,0,35
202409,10984,16,16,0,3,0,3
202409,10356,91,61,30,100,0,100
202409,11887,50,36,14,100,0,100
202501,22706,250,127,123,100,0,100
202409,10341,22,21,1,2,0,2
202501,22770,100,99,1,100,47,53
202501,21155,32,32,0,30,0,30
202501,22006,24,12,12,0,0,0
202501,20758,80,80,0,40,30,10
202501,23959,60,60,0,100,8,92
202409,12725,24,22,2,0,0,0
202501,20109,12,11,1,100,0,100
202501,22141,5,3,2,5,0,5
202409,12048,200,90,110,100,0,100
202409,13943,25,10,15,0,0,0
202409,11586,40,40,0,100,0,100
202409,13764,50,38,12,100,0,100
202409,12982,23,19,4,20,0,20
202409,12416,5,0,5,5,0,5
202409,10160,35,35,0,100,0,100
202501,22965,22,22,0,50,15,35
202501,22183,3,1,2,3,0,3
202409,11705,22,22,0,0,0,0
202501,23030,40,12,28,100,0,100
202409,11706,10,9,1,25,0,25
202409,11501,16,16,0,5,0,5
202501,20630,32,32,0,0,0,0
202409,13590,18,15,3,100,0,100
202409,13806,25,15,10,0,0,0
202409,12180,44,23,21,10,0,10
202409,13829,24,9,15,0,0,0
202501,21283,23,7,16,4,0,4
202409,11731,20,14,6,100,0,100
202501,22747,100,98,2,100,44,56
202409,12742,9,8,1,0,0,0
202409,12423,5,2,3,5,0,5
202409,13980,10,4,6,100,0,100
202409,13163,38,27,11,50,0,50
202501,20984,60,31,29,0,0,0
202501,22252,20,10,10,100,0,100
202409,12709,24,21,3,0,0,0
202409,12199,50,18,32,0,0,0
202409,12808,20,12,8,2,0,2
202501,21621,22,22,0,0,0,0
202409,10080,250,113,137,100,0,100
202409,10902,45,25,20,100,0,100
202501,21440,30,0,30,100,0,100
202501,22145,5,0,5,5,0,5
202501,23121,250,248,2,100,58,42
202501,23778,10,0,10,100,0,100
202409,11505,16,17,-1,5,0,5
202501,20722,15,15,0,0,0,0
202501,20434,92,89,3,0,0,0
202501,20589,100,73,27,80,0,80
202501,21248,100,100,0,100,14,86
202501,21795,30,24,6,30,0,30
202501,21207,32,32,0,30,1,29
202501,21852,20,8,12,100,0,100
202501,20968,35,23,12,0,0,0
202501,22524,24,18,6,0,0,0
202409,11646,5,5,0,0,0,0
202409,10805,55,52,3,0,0,0
202501,21888,200,199,1,200,3,197
202501,20894,20,6,14,3,0,3
202501,20705,20,20,0,0,0,0
202501,22595,20,15,5,100,0,100
202409,11812,30,27,3,5,0,5
202409,10729,30,26,4,0,0,0
202409,11771,50,37,13,100,0,100
202409,13937,25,16,9,0,0,0
202409,10332,22,22,0,2,0,2
202501,22190,50,34,16,100,0,100
202501,21721,70,55,15,20,0,20
202409,13903,10,6,4,100,0,100
202409,10140,22,21,1,100,0,100
202501,20041,120,120,0,50,34,16
202501,21303,22,13,9,4,0,4
202501,21946,60,60,0,35,4,31
202501,23547,5,1,4,5,0,5
202501,21105,75,64,11,50,0,50
202409,14117,15,0,15,0,0,0
202409,13156,22,20,2,50,0,50
202409,13656,25,12,13,100,0,100
202409,11924,20,23,-3,20,0,20
202501,23953,3,1,2,3,0,3
202501,21003,75,43,32,100,0,100
202501,23730,10,5,5,100,0,100
202501,20262,358,358,0,100,47,53
202409,10717,33,29,4,0,0,0
202501,21555,22,19,3,0,0,0
202409,10367,110,107,3,100,0,100
202501,21195,210,204,6,15,0,15
202409,11519,35,26,9,50,0,50
202501,23728,10,6,4,100,0,100
202501,22177,5,0,5,5,0,5
202409,10331,170,111,59,100,0,100
202409,12036,46,43,3,20,0,20
202409,10393,299,201,98,100,0,100
202501,20833,60,60,0,100,2,98
202501,21641,38,38,0,100,0,100
202501,21638,35,24,11,100,0,100
202501,21691,30,7,23,5,0,5
202501,23089,16,13,3,100,0,100
202409,10159,18,17,1,100,0,100
202501,22584,45,45,0,100,9,91
202409,11339,22,22,0,100,0,100
202409,11352,23,22,1,23,0,23
202409,11704,22,22,0,0,0,0
202409,10104,30,18,12,100,0,100
202409,11394,25,20,5,4,0,4
202409,12544,47,47,0,0,0,0
202501,22210,5,1,4,5,0,5
202501,22258,7,6,1,7,0,7
202501,20995,75,33,42,100,0,100
202501,21271,50,50,0,50,7,43
202409,12924,100,98,2,100,0,100
202501,21465,19,19,0,10,2,8
202409,10162,30,27,3,100,0,100
202409,13788,175,165,10,10,0,10
202501,21562,22,22,0,0,0,0
202409,13016,55,48,7,25,0,25
202409,11404,25,25,0,4,0,4
202409,12085,205,194,11,100,0,100
202409,10467,92,90,2,0,0,0
202501,20828,30,30,0,100,5,95
202409,10238,32,32,0,100,0,100
202409,10953,117,110,7,50,0,50
202501,21416,15,7,8,5,0,5
202501,22566,24,23,1,0,0,0
202501,21474,50,50,0,100,0,100
202501,23504,30,19,11,100,0,100
202501,20343,20,14,6,4,0,4
202501,20292,24,24,0,4,4,0
202409,11262,80,80,0,25,0,25
202501,20097,50,50,0,100,12,88
202409,13957,30,24,6,0,0,0
202501,20213,32,32,0,100,6,94
202501,22245,3,1,2,3,0,3
202501,22299,3,1,2,3,0,3
202409,10247,26,26,0,10,0,10
202501,21264,22,22,0,22,5,17
202409,11021,24,15,9,50,0,50
202501,23564,70,56,14,100,0,100
202501,20045,30,30,0,15,3,12
202409,12687,30,24,6,15,0,15
202501,20631,32,32,0,0,0,0
202501,20650,30,14,16,0,0,0
202409,11191,66,63,3,0,0,0
202501,20309,20,20,0,2,2,0
202501,23457,12,10,2,0,0,0
202409,12352,6,0,6,100,0,100
202409,11422,40,22,18,100,0,100
202409,10656,56,33,23,50,0,50
202409,12385,3,1,2,3,0,3
202501,22840,45,45,0,10,5,5
202409,10590,20,20,0,2,0,2
202501,20888,16,16,0,3,0,3
202409,12759,30,11,19,0,0,0
202409,11001,68,47,21,50,0,50
202409,12445,3,0,3,3,0,3
202409,13000,16,16,0,10,0,10
202501,21982,30,21,9,20,0,20
202501,22573,20,11,9,4,0,4
202409,13981,10,3,7,100,0,100
202409,13122,18,2,16,30,0,30
202501,23446,18,20,-2,0,0,0
202501,23878,4,2,2,0,0,0
202501,21652,50,38,12,100,0,100
202501,21446,10,0,10,100,0,100
202501,21006,70,47,23,100,0,100
202409,12296,60,57,3,100,0,100
202409,11578,50,49,1,100,0,100
202501,21790,20,9,11,20,0,20
202501,23627,20,2,18,0,0,0
202409,11275,31,28,3,30,0,30
202409,12311,5,2,3,5,0,5
202501,20919,30,27,3,42,0,42
202501,20272,24,24,0,4,4,0
202501,22855,90,59,31,10,0,10
202501,23596,30,0,30,0,0,0
202409,11490,16,15,1,1,0,1
202501,20170,30,25,5,0,0,0
202501,23770,10,3,7,100,0,100
202501,22307,5,1,4,5,0,5
202409,12432,5,2,3,5,0,5
202501,21842,28,16,12,100,0,100
202501,22582,9,9,0,0,0,0
202501,23172,24,24,0,100,4,96
202501,21406,16,10,6,5,0,5
202501,21419,32,21,11,30,0,30
202409,11916,50,42,8,50,0,50
202409,10285,24,24,0,4,0,4
202409,11110,60,29,31,100,0,100
202501,22004,24,21,3,0,0,0
202501,23897,100,6,94,100,0,100
202409,10691,58,56,2,25,0,25
202501,21115,31,31,0,0,0,0
202501,20920,20,20,0,50,1,49
202409,12715,24,22,2,0,0,0
202409,12827,15,12,3,0,0,0
202501,23101,2,2,0,100,0,100
202409,11522,67,63,4,10,0,10
202409,12425,5,0,5,5,0,5
202409,12379,5,0,5,5,0,5
202501,21363,75,75,0,100,4,96
202409,12807,110,64,46,100,0,100
202409,11103,93,89,4,100,0,100
202409,12576,35,14,21,20,0,20
202501,20044,30,30,0,15,7,8
202501,22128,5,0,5,5,0,5
202501,21306,22,20,2,4,0,4
202409,11697,22,22,0,0,0,0
202409,10584,16,16,0,2,0,2
202409,12585,90,29,61,20,0,20
202501,23573,25,21,4,100,0,100
202501,20037,30,30,0,20,1,19
202501,20870,10,4,6,3,0,3
202501,23875,2,2,0,0,0,0
202409,13653,6,0,6,0,0,0
202409,12855,50,39,11,100,0,100
202409,13902,10,0,10,100,0,100
202501,23763,14,11,3,100,0,100
202501,22940,17,25,-8,100,13,87
202501,22000,16,4,12,10,0,10
202409,14243,1,1,0,0,0,0
202501,20585,35,51,-16,0,0,0
202501,22579,9,9,0,0,0,0
202501,22399,80,0,80,0,0,0
202501,20241,60,14,46,100,0,100
202409,13228,211,208,3,75,0,75
202501,20359,20,20,0,4,4,0
202501,23170,50,35,15,100,0,100
202501,23774,10,1,9,100,0,100
202501,23785,10,3,7,100,0,100
202501,21080,33,33,0,0,0,0
202501,22741,35,34,1,0,0,0
202501,23648,25,0,25,0,0,0
202501,22021,110,70,40,100,0,100
202501,20533,37,35,2,15,0,15
202501,20627,150,148,2,40,18,22
202409,13091,40,39,1,100,0,100
202409,12910,35,32,3,0,0,0
202501,23164,20,20,0,100,11,89
202409,12628,40,28,12,20,0,20
202409,10504,30,12,18,4,0,4
202501,20605,64,62,2,10,0,10
202409,11298,27,27,0,10,0,10
202501,21459,24,9,15,5,0,5
202409,10212,32,31,1,100,0,100
202409,11782,25,23,2,10,0,10
202501,20363,200,200,0,100,28,72
202409,11300,4,4,0,3,0,3
202409,12895,25,24,1,0,0,0
202501,20305,358,342,16,100,0,100
202409,11644,5,5,0,0,0,0
202409,12020,50,48,2,20,0,20
202409,13617,15,7,8,100,0,100
202501,22295,3,0,3,3,0,3
202409,11385,56,50,6,50,0,50
202501,21687,81,49,32,5,0,5
202409,10624,80,64,16,50,0,50
202501,21786,70,51,19,50,0,50
202409,11442,50,21,29,100,0,100
202501,22928,80,64,16,100,0,100
202501,20993,30,10,20,0,0,0
202409,12066,215,195,20,90,0,90
202501,23441,30,16,14,100,0,100
202409,10149,20,22,-2,100,0,100
202501,23025,30,30,0,100,2,98
202501,20152,30,30,0,100,2,98
202409,11263,32,32,0,30,0,30
202501,22276,5,0,5,0,0,0
202409,12714,24,24,0,0,0,0
202501,20019,33,33,0,50,1,49
202501,22282,5,1,4,5,0,5
202501,22224,5,2,3,5,0,5
202501,22803,30,21,9,20,0,20
202501,21908,40,38,2,40,0,40
202501,21238,200,189,11,100,0,100
202409,10744,31,31,0,0,0,0
202501,21177,20,2,18,10,0,10
202501,20882,100,50,50,50,0,50
202501,22727,200,198,2,100,68,32
202409,11473,18,18,0,5,0,5
202409,11330,33,33,0,100,0,100
202409,11215,33,13,20,0,0,0
202409,10645,64,61,3,10,0,10
202409,10473,92,58,34,0,0,0
202501,20887,16,16,0,3,0,3
202501,20814,60,60,0,100,3,97
202501,20136,90,88,2,100,1,99
202501,21254,40,40,0,40,4,36
202409,10183,18,16,2,0,0,0
202409,12811,20,11,9,2,0,2
202409,11488,110,104,6,3,0,3
202501,21153,32,31,1,30,7,23
202501,20701,15,1,14,10,0,10
202501,23161,50,26,24,100,0,100
202409,11772,53,50,3,100,0,100
202501,21375,16,12,4,5,0,5
202501,22970,38,38,0,50,15,35
202501,20588,85,35,50,80,0,80
202409,10517,16,15,1,4,0,4
202409,12896,25,25,0,0,0,0
202409,13691,60,27,33,100,0,100
202409,10690,60,41,19,10,0,10
202501,22503,24,24,0,0,0,0
202409,12060,40,27,13,10,0,10
202409,13168,11,10,1,30,0,30
202501,20898,16,16,0,3,1,2
202501,20695,30,29,1,0,0,0
202409,14199,5,1,4,5,0,5
202409,10157,24,18,6,100,0,100
202409,10158,24,23,1,100,0,100
202409,11587,30,32,-2,30,0,30
202409,12260,81,65,16,25,0,25
202409,11264,32,31,1,30,0,30
202409,12377,5,1,4,5,0,5
202409,11821,53,42,11,5,0,5
202501,22645,20,16,4,2,0,2
202501,21757,50,0,50,100,0,100
202501,21953,60,35,25,30,0,30
202409,11272,32,26,6,30,0,30
202501,22467,60,30,30,100,0,100
202501,23737,70,70,0,100,43,57
202501,21386,30,30,0,100,9,91
202501,20371,18,16,2,4,0,4
202409,11936,30,9,21,30,0,30
202409,12540,50,50,0,0,0,0
202501,21507,20,20,0,100,0,100
202501,21753,35,35,0,100,2,98
202501,22718,25,25,0,0,0,0
202409,12286,5,2,3,5,0,5
202409,11872,335,331,4,100,0,100
202501,21315,20,17,3,4,0,4
202501,20616,64,63,1,10,0,10
202501,21307,22,22,0,4,1,3
202409,10232,32,30,2,100,0,100
202409,11722,20,16,4,20,0,20
202409,13266,16,14,2,100,0,100
202409,10990,140,130,10,50,0,50
202501,21965,30,15,15,15,0,15
202501,21673,45,36,9,100,0,100
202501,20611,64,63,1,10,0,10
202409,11982,6,4,2,15,0,15
202409,12426,5,1,4,5,0,5
202409,13908,10,7,3,100,0,100
202409,12436,5,2,3,5,0,5
202501,22459,120,80,40,100,0,100
202409,12950,25,25,0,30,0,30
202409,12187,28,27,1,16,0,16
202409,12213,25,0,25,5,0,5
202501,23922,35,0,35,0,0,0
202501,23478,15,9,6,0,0,0
202501,22291,3,1,2,3,0,3
202501,20985,60,41,19,0,0,0
202501,22931,80,80,0,100,0,100
202501,22847,72,72,0,10,5,5
202409,13224,60,42,18,0,0,0
202409,10398,21,25,-4,1,0,1
202409,11268,32,32,0,30,0,30
202501,20461,30,30,0,4,1,3
202501,21560,22,20,2,0,0,0
202409,11387,25,21,4,4,0,4
202501,23550,40,29,11,100,0,100
202501,21884,40,23,17,17,0,17
202501,21055,35,20,15,50,0,50
202409,12193,65,42,23,30,0,30
202409,10400,58,60,-2,100,0,100
202409,10697,33,33,0,0,0,0
202409,10799,17,14,3,0,0,0
202501,22002,20,16,4,10,0,10
202501,22424,35,31,4,100,0,100
202501,23510,25,7,18,100,0,100
202501,23936,20,0,20,0,0,0
202409,11557,24,13,11,5,0,5
202409,12616,150,124,26,100,0,100
202501,22264,5,0,5,5,0,5
202409,12542,46,46,0,0,0,0
202409,10730,30,17,13,0,0,0
202501,22451,50,10,40,100,0,100
202409,12452,3,1,2,3,0,3
202409,10833,11,11,0,25,0,25
202501,21833,38,38,0,100,13,87
202501,21667,25,8,17,0,0,0
202501,21201,40,40,0,5,4,1
202409,11997,40,10,30,100,0,100
202501,22507,24,24,0,0,0,0
202409,12022,50,43,7,12,0,12
202501,23782,10,3,7,100,0,100
202409,11187,35,32,3,0,0,0
202409,10083,75,42,33,100,0,100
202409,13652,6,0,6,0,0,0
202409,11064,35,34,1,0,0,0
202501,21846,30,8,22,50,0,50
202501,22038,80,75,5,10,0,10
202409,11692,22,23,-1,0,0,0
202501,21241,23,23,0,23,5,18
202409,13847,50,50,0,100,0,100
202501,21520,35,13,22,10,0,10
202409,10196,13,8,5,0,0,0
202501,20400,12,2,10,50,0,50
202501,21352,18,16,2,5,4,1
202409,14051,2,0,2,0,0,0
202501,21448,24,22,2,5,0,5
202501,20612,64,62,2,10,0,10
202501,22825,65,64,1,25,1,24
202409,13683,18,1,17,50,0,50
202409,12291,5,0,5,5,0,5
202501,21122,66,63,3,0,0,0
202409,10084,100,82,18,100,0,100
202501,23124,15,13,2,100,0,100
202501,23906,25,9,16,0,0,0
202501,23848,30,23,7,0,0,0
202501,20658,15,7,8,10,0,10
202501,20896,120,119,1,50,0,50
202501,23825,25,9,16,0,0,0
202501,21664,53,50,3,100,0,100
202501,21927,80,74,6,40,0,40
202409,13300,15,12,3,100,0,100
202409,11605,25,10,15,10,0,10
202409,10573,40,40,0,15,0,15
202501,22009,24,8,16,0,0,0
202409,11500,16,16,0,5,0,5
202409,10891,60,20,40,100,0,100
202501,21054,150,38,112,100,0,100
202409,11986,20,8,12,0,0,0
202409,13047,78,74,4,100,0,100
202501,20188,30,22,8,100,0,100
202501,22712,25,25,0,0,0,0
202501,21081,33,33,0,0,0,0
202409,12975,30,20,10,20,0,20
202409,11421,30,23,7,0,0,0
202409,12891,25,25,0,0,0,0
202409,14072,38,29,9,50,0,50
202409,11216,33,20,13,0,0,0
202409,10700,33,30,3,0,0,0
202501,22048,18,17,1,10,2,8
202409,10795,17,15,2,0,0,0
202501,20174,18,17,1,0,0,0
202501,21471,110,4,106,100,0,100
202501,23549,75,50,25,100,0,100
202409,12101,165,157,8,75,0,75
202409,10439,20,11,9,5,0,5
202501,21119,35,35,0,100,9,91
202501,22147,60,49,11,100,0,100
202501,22148,30,11,19,100,0,100
202501,21576,22,22,0,0,0,0
202409,11297,30,30,0,10,0,10
202409,13961,10,0,10,100,0,100
202501,20593,80,26,54,5,0,5
202409,12053,40,35,5,10,0,10
202501,23542,18,9,9,30,0,30
202409,11975,5,0,5,0,0,0
202501,22053,25,22,3,20,0,20
202409,12000,10,8,2,100,0,100
202501,21854,28,28,0,100,19,81
202409,12547,21,15,6,0,0,0
202409,12357,20,11,9,100,0,100
202409,14093,100,10,90,0,0,0
202409,11969,20,1,19,100,0,100
202409,12086,135,125,10,60,0,60
202409,13864,24,14,10,100,0,100
202409,11583,175,50,125,100,0,100
202409,10510,30,27,3,4,0,4
202409,12660,24,24,0,0,0,0
202409,11063,35,35,0,0,0,0
202409,12330,5,2,3,5,0,5
202501,20629,32,32,0,0,0,0
202409,11487,15,14,1,5,0,5
202409,12324,5,1,4,5,0,5
202501,21861,40,40,0,100,0,100
202409,12812,20,6,14,2,0,2
202409,10898,60,54,6,100,0,100
202409,11161,33,33,0,0,0,0
202501,20692,30,29,1,0,0,0
202409,12858,20,15,5,100,0,100
202501,23141,10,7,3,100,0,100
202409,10250,26,20,6,10,0,10
202409,12168,80,31,49,20,0,20
202501,23175,14,14,0,100,0,100
202409,13155,22,15,7,50,0,50
202501,20910,9,9,0,3,0,3
202409,12401,3,0,3,3,0,3
202409,11390,25,23,2,4,0,4
202409,10327,22,22,0,4,0,4
202501,22833,35,34,1,40,17,23
202409,13909,10,0,10,100,0,100
202501,23765,10,2,8,100,0,100
202409,11992,45,42,3,100,0,100
202501,22682,25,25,0,100,0,100
202501,21732,100,99,1,100,46,54
202501,22280,5,0,5,5,0,5
202409,11881,64,61,3,100,0,100
202409,10828,148,127,21,14,0,14
202409,13012,38,31,7,0,0,0
202409,13041,35,29,6,100,0,100
202501,22232,3,0,3,3,0,3
202409,13087,80,78,2,100,0,100
202409,12424,5,0,5,5,0,5
202409,11313,3,3,0,3,0,3
202409,13914,17,23,-6,100,0,100
202409,11166,33,32,1,0,0,0
202409,10825,15,13,2,0,0,0
202409,13102,64,63,1,100,0,100
202409,11715,22,16,6,0,0,0
202501,23555,5,3,2,100,0,100
202409,10093,22,20,2,10,0,10
202409,10323,22,22,0,4,0,4
202409,12615,420,374,46,100,0,100
202501,22300,20,5,15,10,0,10
202409,11452,15,7,8,100,0,100
202409,12420,5,1,4,5,0,5
202501,23869,25,15,10,0,0,0
202409,12024,50,45,5,20,0,20
202501,22896,25,24,1,100,0,100
202501,22904,25,21,4,100,0,100
202409,13681,18,9,9,30,0,30
202409,12659,24,24,0,0,0,0
202501,21101,30,12,18,25,0,25
202409,11060,35,35,0,0,0,0
202409,11855,140,72,68,100,0,100
202501,20078,25,5,20,20,0,20
202501,23046,50,24,26,20,0,20
202409,10701,33,31,2,0,0,0
202409,11109,90,21,69,100,0,100
202501,22284,5,0,5,5,0,5
202501,21834,38,37,1,100,9,91
202501,23183,30,30,0,100,0,100
202409,11468,18,19,-1,5,0,5
202409,12550,21,18,3,0,0,0
202501,20866,15,9,6,50,0,50
202409,12301,30,23,7,100,0,100
202409,11714,22,20,2,0,0,0
202409,13226,200,193,7,70,0,70
202409,12267,60,42,18,100,0,100
202501,22735,35,35,0,0,0,0
202501,22243,3,0,3,2,0,2
202501,21911,40,32,8,40,0,40
202409,10311,20,20,0,4,0,4
202409,12943,25,24,1,100,0,100
202409,12153,24,23,1,10,0,10
202409,10763,21,19,2,0,0,0
202501,20991,85,45,40,100,0,100
202409,11058,35,35,0,0,0,0
202501,21192,2,0,2,1,0,1
202501,22781,25,25,0,100,28,72
202409,14121,15,0,15,0,0,0
202501,20547,30,15,15,100,0,100
202409,13227,186,90,96,75,0,75
202501,20473,16,16,0,4,4,0
202501,23855,5,0,5,6,0,6
202501,20263,358,357,1,100,32,68
202501,22279,5,2,3,5,0,5
202501,21843,23,23,0,100,0,100
202409,12186,27,27,0,16,0,16
202501,22447,10,10,0,0,0,0
202501,22170,5,3,2,5,0,5
202501,20231,24,23,1,10,0,10
202409,11755,35,30,5,100,0,100
202409,10580,16,16,0,2,0,2
202501,21519,43,16,27,10,0,10
202501,20280,24,24,0,4,4,0
202501,20665,30,30,0,0,0,0
202409,11884,50,12,38,100,0,100
202409,10817,70,55,15,0,0,0
202501,22157,20,9,11,100,0,100
202409,11440,22,20,2,4,0,4
202409,13676,10,7,3,100,0,100
202501,21582,22,22,0,0,0,0
202501,20883,100,74,26,50,0,50
202409,11725,22,12,10,0,0,0
202501,20661,20,3,17,10,0,10
202409,10360,16,5,11,4,0,4
202409,14270,2,2,0,0,0,0
202501,22558,24,24,0,0,0,0
202501,22552,24,24,0,0,0,0
202501,21642,60,18,42,100,0,100
202409,12806,20,13,7,2,0,2
202409,10109,60,8,52,100,0,100
202501,23047,50,15,35,20,0,20
202409,12422,5,0,5,5,0,5
202501,21627,30,26,4,30,0,30
202501,22306,20,2,18,20,0,20
202501,20159,30,29,1,5,5,0
202409,11403,24,23,1,4,0,4
202409,10396,50,50,0,100,0,100
202409,12192,55,42,13,30,0,30
202409,13646,14,7,7,100,0,100
202501,22171,5,0,5,5,0,5
202501,20457,30,30,0,4,1,3
202409,10390,20,18,2,4,0,4
202409,11864,48,51,-3,100,0,100
202501,21456,24,21,3,5,0,5
202501,23709,17,24,-7,100,15,85
202501,21690,80,7,73,5,0,5
202501,22473,40,39,1,100,0,100
202409,10117,26,22,4,100,0,100
202501,21106,100,25,75,100,0,100
202409,10319,22,16,6,4,0,4
202409,12252,24,18,6,5,0,5
202409,10385,20,20,0,4,0,4
202501,22577,50,39,11,100,0,100
202409,11527,15,9,6,5,0,5
202409,11484,15,14,1,5,0,5
202409,12314,5,1,4,5,0,5
202409,13754,60,57,3,100,0,100
202409,10220,23,22,1,50,0,50
202409,10636,64,65,-1,10,0,10
202501,20554,12,12,0,10,6,4
202409,10614,60,55,5,50,0,50
202501,21625,24,24,0,24,5,19
202409,11054,300,300,0,100,0,100
202409,11405,24,23,1,4,0,4
202501,21260,23,23,0,23,6,17
202409,12320,5,3,2,5,0,5
202501,22105,22,19,3,5,0,5
202501,23801,5,0,5,0,0,0
202501,21549,22,22,0,0,0,0
202409,10814,23,21,2,0,0,0
202501,20864,10,10,0,3,1,2
202409,11492,16,14,2,0,0,0
202501,21534,50,45,5,100,0,100
202409,11845,70,56,14,20,0,20
202501,20096,60,60,0,100,6,94
202501,23513,6,0,6,0,0,0
202409,11092,30,30,0,0,0,0
202501,21671,270,211,59,100,0,100
202409,10027,30,30,0,75,0,75
202409,10274,358,345,13,100,0,100
202409,12374,5,2,3,5,0,5
202501,23104,2,2,0,0,0,0
202501,20869,10,5,5,3,0,3
202501,22014,32,25,7,10,0,10
202409,12166,24,22,2,10,0,10
202501,22296,3,0,3,3,0,3
202409,10391,20,20,0,4,0,4
202501,23135,15,10,5,100,0,100
202409,10325,22,22,0,4,0,4
202409,12737,18,18,0,0,0,0
202409,11761,35,14,21,50,0,50
202409,11345,64,60,4,60,0,60
202409,10682,31,28,3,0,0,0
202409,10177,18,16,2,0,0,0
202409,10533,10,6,4,4,0,4
202409,13976,10,8,2,100,0,100
202409,10489,30,29,1,4,0,4
202501,21660,25,22,3,10,0,10
202501,23776,10,0,10,100,0,100
202409,14138,22,20,2,20,0,20
202409,10047,120,117,3,30,0,30
202501,22133,5,2,3,5,0,5
202409,10091,22,17,5,10,0,10
202501,23740,33,29,4,100,0,100
202409,10970,96,72,24,50,0,50
202501,22215,5,2,3,5,0,5
202501,23493,20,15,5,30,0,30
202409,13731,14,14,0,100,0,100
202409,11643,30,23,7,0,0,0
202409,14107,20,16,4,0,0,0
202501,20160,18,17,1,0,0,0
202501,22572,25,19,6,5,0,5
202501,20205,32,32,0,100,15,85
202409,11014,96,72,24,50,0,50
202501,22189,16,13,3,100,0,100
202409,12183,151,93,58,30,0,30
202501,21700,53,23,30,5,0,5
202501,21583,22,22,0,0,0,0
202409,12210,40,20,20,0,0,0
202501,21886,40,7,33,17,0,17
202409,10786,60,56,4,0,0,0
202409,10750,31,24,7,0,0,0
202409,10413,30,23,7,100,0,100
202501,20378,24,18,6,4,4,0
202501,22431,35,28,7,30,0,30
202501,21689,30,21,9,10,0,10
202409,12285,5,2,3,5,0,5
202501,22623,140,112,28,100,0,100
202501,23829,25,17,8,0,0,0
202501,22512,24,24,0,0,0,0
202501,22521,24,16,8,0,0,0
202409,10588,20,21,-1,2,0,2
202501,22967,38,38,0,50,2,48
202501,22091,75,75,0,10,9,1
202409,12617,60,39,21,100,0,100
202501,22229,3,1,2,3,0,3
202409,10818,140,135,5,25,0,25
202409,13065,25,21,4,100,0,100
202409,11844,60,46,14,20,0,20
202501,20172,18,18,0,0,0,0
202409,14133,12,12,0,4,0,4
202409,13093,80,78,2,100,0,100
202501,21103,20,5,15,25,0,25
202409,11441,22,19,3,4,0,4
202409,11996,27,26,1,100,0,100
202501,21421,32,23,9,50,0,50
202409,13846,10,7,3,100,0,100
202409,11977,88,79,9,100,0,100
202501,22205,5,0,5,5,0,5
202409,12096,50,50,0,25,0,25
202409,12763,24,15,9,100,0,100
202409,11753,35,21,14,100,0,100
202409,10315,20,20,0,4,0,4
202409,10971,30,25,5,3,0,3
202409,11776,53,43,10,100,0,100
202501,21539,22,22,0,0,0,0
202409,11159,66,32,34,0,0,0
202409,11673,100,95,5,100,0,100
202501,22273,5,1,4,5,0,5
202501,22776,20,20,0,100,10,90
202409,13231,80,70,10,100,0,100
202409,10336,22,20,2,2,0,2
202409,10616,50,50,0,50,0,50
202501,21472,50,50,0,100,13,87
202501,20761,15,13,2,10,0,10
202409,12756,24,24,0,0,0,0
202409,12622,60,57,3,100,0,100
202409,12084,210,207,3,100,0,100
202501,22568,68,66,2,10,0,10
202409,10337,22,22,0,2,0,2
202501,20719,15,15,0,0,0,0
202501,21678,60,60,0,100,4,96
202501,20214,32,32,0,100,12,88
202501,20924,30,30,0,3,3,0
202501,20266,24,24,0,4,3,1
202501,21616,30,15,15,30,0,30
202501,22186,3,0,3,3,0,3
202501,20431,92,92,0,0,0,0
202409,13206,35,22,13,100,0,100
202409,10545,25,14,11,100,0,100
202501,23083,16,12,4,100,0,100
202409,10063,15,11,4,5,0,5
202501,22249,25,8,17,100,0,100
202501,21327,54,23,31,100,0,100
202409,10651,55,44,11,50,0,50
202501,22117,60,42,18,100,0,100
202501,21277,23,23,0,4,1,3
202501,22272,5,0,5,5,0,5
202409,13037,30,16,14,0,0,0
202501,22481,9,8,1,100,0,100
202409,12382,5,2,3,5,0,5
202409,10382,150,91,59,100,0,100
202409,11174,45,41,4,100,0,100
202501,20735,65,65,0,0,0,0
202501,20700,90,48,42,10,0,10
202501,21964,20,13,7,10,0,10
202409,11719,22,17,5,0,0,0
202501,22561,24,24,0,0,0,0
202501,23048,200,199,1,90,23,67
202501,21011,88,66,22,100,0,100
202409,10523,80,49,31,100,0,100
202409,12750,10,10,0,0,0,0
202409,11651,132,115,17,100,0,100
202501,22742,35,32,3,0,0,0
202409,12914,35,27,8,0,0,0
202501,23163,20,20,0,100,0,100
202501,22987,38,38,0,50,8,42
202409,12023,50,33,17,20,0,20
202409,11104,91,90,1,100,0,100
202501,23059,26,19,7,100,0,100
202409,11894,16,14,2,100,0,100
202501,23559,60,57,3,100,0,100
202409,10176,18,14,4,0,0,0
202409,13295,30,17,13,100,0,100
202501,21163,30,30,0,2,1,1
202409,13252,20,21,-1,100,0,100
202409,10657,50,33,17,50,0,50
202501,22008,24,9,15,0,0,0
202409,11437,54,31,23,100,0,100
202501,21737,40,10,30,100,0,100
202501,20832,60,28,32,100,0,100
202409,10475,80,55,25,100,0,100
202409,10364,20,21,-1,4,0,4
202409,10178,18,10,8,0,0,0
202501,23841,40,40,0,100,0,100
202501,20970,150,148,2,100,15,85
202501,20312,20,20,0,2,2,0
202409,13274,15,3,12,100,0,100
202409,12032,50,34,16,10,0,10
202409,11140,40,9,31,100,0,100
202409,11018,24,15,9,50,0,50
202409,12662,24,23,1,0,0,0
202409,10303,24,24,0,4,0,4
202501,22442,15,4,11,0,0,0
202409,11850,30,28,2,10,0,10
202501,22241,3,0,3,3,0,3
202409,12888,25,24,1,0,0,0
202501,21851,35,19,16,100,0,100
202409,13718,50,50,0,100,0,100
202501,23081,80,77,3,100,0,100
202409,13839,20,0,20,0,0,0
202409,13985,10,1,9,100,0,100
202409,10296,24,24,0,4,0,4
202501,23970,15,14,1,15,0,15
202409,11579,50,49,1,100,0,100
202409,13141,22,19,3,50,0,50
202409,12998,45,34,11,10,0,10
202409,10655,56,46,10,50,0,50
202409,11218,22,21,1,0,0,0
202501,22283,5,2,3,5,0,5
202409,13269,16,13,3,100,0,100
202409,10689,55,52,3,25,0,25
202501,22704,317,317,0,100,1,99
202409,13682,18,7,11,30,0,30
202501,20978,30,30,0,0,0,0
202501,21945,60,60,0,35,21,14
202409,10175,18,14,4,0,0,0
202409,11181,31,31,0,0,0,0
202409,11733,30,28,2,40,0,40
202501,21154,32,31,1,30,3,27
202409,11282,32,31,1,2,0,2
202409,12826,15,13,2,2,0,2
202409,11173,66,63,3,0,0,0
202501,21551,22,17,5,0,0,0
202409,13791,100,100,0,20,0,20
202501,22850,45,21,24,50,0,50
202409,14120,15,0,15,0,0,0
202409,11683,22,22,0,0,0,0
202409,10225,32,32,0,100,0,100
202409,12119,25,19,6,20,0,20
202409,13732,12,12,0,100,0,100
202501,20162,18,15,3,0,0,0
202409,10987,16,0,16,3,0,3
202409,10836,13,12,1,0,0,0
202409,11675,22,21,1,0,0,0
202409,11360,40,27,13,40,0,40
202409,12126,20,8,12,7,0,7
202409,13949,25,15,10,0,0,0
202409,11334,33,33,0,100,0,100
202409,12739,50,38,12,100,0,100
202501,23086,20,10,10,100,0,100
202409,11950,24,8,16,15,0,15
202501,21856,75,74,1,100,7,93
202409,11098,30,28,2,0,0,0
202409,12310,5,1,4,5,0,5
202501,21009,90,35,55,100,0,100
202409,10351,22,22,0,2,0,2
202501,21270,50,50,0,50,19,31
202409,13923,35,22,13,20,0,20
202501,23786,10,1,9,100,0,100
202501,21956,45,40,5,22,0,22
202501,20030,45,45,0,50,17,33
202409,13165,38,34,4,50,0,50
202409,12683,24,24,0,0,0,0
202501,22588,9,9,0,0,0,0
202409,11665,22,22,0,0,0,0
202501,20897,16,16,0,3,2,1
202409,11530,35,18,17,50,0,50
202501,21301,66,32,34,100,0,100
202409,13248,30,19,11,100,0,100
202409,13932,80,25,55,5,0,5
202501,23659,33,33,0,0,0,0
202409,11069,35,35,0,0,0,0
202409,11012,28,27,1,3,0,3
202501,22657,20,16,4,2,0,2
202409,12376,5,0,5,5,0,5
202501,21899,40,40,0,40,9,31
202501,21320,40,40,0,100,14,86
202501,21920,40,39,1,20,0,20
202501,22589,9,1,8,0,0,0
202501,21204,40,40,0,5,3,2
202409,10548,20,0,20,0,0,0
202501,23088,2,1,1,0,0,0
202409,13066,25,25,0,100,0,100
202501,22509,24,22,2,0,0,0
202409,10359,16,10,6,4,0,4
202501,20881,24,14,10,3,0,3
202409,12619,35,23,12,20,0,20
202409,13956,30,22,8,0,0,0
202409,11575,10,1,9,25,0,25
202501,22547,24,24,0,0,0,0
202409,10733,215,204,11,25,0,25
202501,23840,5,1,4,3,0,3
202501,21610,65,65,0,65,11,54
202409,11604,70,22,48,10,0,10
202501,23092,20,13,7,100,0,100
202409,12198,50,18,32,20,0,20
202501,21060,33,33,0,0,0,0
202409,13634,20,15,5,30,0,30
202409,12387,3,2,1,3,0,3
202409,12583,35,31,4,20,0,20
202409,12898,250,232,18,100,0,100
202501,22469,35,32,3,100,0,100
202409,11687,66,63,3,40,0,40
202409,12918,35,32,3,0,0,0
202409,12400,3,0,3,2,0,2
202409,10277,24,23,1,4,0,4
202501,22941,17,25,-8,100,20,80
202409,10378,24,23,1,4,0,4
202501,23562,60,61,-1,100,0,100
202501,22130,5,0,5,5,0,5
202409,14037,10,4,6,100,0,100
202409,12788,20,20,0,2,0,2
202501,21381,30,27,3,5,0,5
202501,21000,30,0,30,0,0,0
202409,13031,30,28,2,25,0,25
202409,10248,26,22,4,10,0,10
202409,12362,5,0,5,5,0,5
202501,22869,25,16,9,100,0,100
202501,21622,22,20,2,0,0,0
202501,23126,15,15,0,100,0,100
202409,14073,38,31,7,50,0,50
202409,11728,22,23,-1,0,0,0
202409,13045,33,7,26,100,0,100
202501,21031,30,9,21,100,0,100
202409,10357,16,9,7,4,0,4
202501,21100,20,20,0,25,0,25
202409,12288,5,0,5,5,0,5
202501,21796,66,63,3,30,0,30
202409,11160,33,32,1,0,0,0
202501,20105,30,30,0,20,19,1
202409,13734,12,9,3,100,0,100
202501,22266,5,2,3,5,0,5
202409,11784,20,7,13,100,0,100
202501,21545,22,22,0,0,0,0
202409,10253,24,22,2,10,0,10
202409,12689,24,19,5,0,0,0
202409,12595,35,13,22,20,0,20
202501,21761,15,15,0,100,0,100
202501,21113,66,64,2,0,0,0
202501,21362,75,75,0,100,0,100
202501,23838,21,21,0,100,3,97
202409,11783,35,20,15,100,0,100
202501,20216,32,32,0,100,10,90
202409,10368,22,22,0,4,0,4
202501,20718,15,15,0,0,0,0
202501,20834,30,25,5,100,0,100
202501,23748,30,10,20,20,0,20
202501,21746,50,37,13,100,0,100
202501,21585,92,92,0,40,16,24
202501,22528,24,22,2,0,0,0
202409,12398,3,1,2,2,0,2
202501,22779,25,25,0,100,42,58
202409,12313,5,0,5,5,0,5
202501,22845,40,39,1,0,0,0
202501,20628,32,32,0,0,0,0
202409,10644,64,65,-1,10,0,10
202501,21860,15,15,0,100,0,100
202409,11627,34,11,23,10,0,10
202409,10962,46,40,6,50,0,50
202409,13645,14,8,6,100,0,100
202409,13002,40,40,0,0,0,0
202409,11620,35,29,6,20,0,20
202409,11807,40,32,8,10,0,10
202409,14056,13,13,0,5,0,5
202409,12318,5,1,4,5,0,5
202501,23578,30,20,10,0,0,0
202409,13930,40,37,3,10,0,10
202501,21191,2,0,2,1,0,1
202501,22982,38,38,0,50,10,40
202409,11499,96,100,-4,30,0,30
202409,12814,80,69,11,100,0,100
202409,10783,27,27,0,25,0,25
202409,11846,35,23,12,10,0,10
202501,20498,20,0,20,0,0,0
202501,21593,22,22,0,0,0,0
202409,12354,5,0,5,5,0,5
202501,22112,117,75,42,100,0,100
202501,22011,80,56,24,0,0,0
202501,23127,15,15,0,100,2,98
202409,10752,45,28,17,10,0,10
202501,20890,20,12,8,3,0,3
202409,11592,12,9,3,15,0,15
202409,10613,50,50,0,50,0,50
202409,11971,28,21,7,100,0,100
202501,23732,10,1,9,100,0,100
202409,12317,5,1,4,5,0,5
202501,21587,23,22,1,0,0,0
202409,12835,140,126,14,100,0,100
202501,22804,90,52,38,50,0,50
202409,12925,100,101,-1,100,0,100
202501,21615,40,40,0,100,37,63
202409,11071,35,33,2,0,0,0
202501,21501,160,123,37,100,0,100
202409,11267,32,31,1,30,0,30
202409,10350,22,21,1,2,0,2
202409,13035,28,27,1,0,0,0
202501,23568,50,38,12,100,0,100
202501,22673,50,48,2,100,7,93
202409,12025,50,45,5,20,0,20
202409,13130,22,22,0,30,0,30
202501,22648,110,88,22,100,0,100
202409,12197,50,26,24,30,0,30
202501,22246,20,5,15,10,0,10
202501,21210,130,129,1,10,8,2
202501,21865,18,7,11,100,0,100
202501,22730,100,100,0,100,17,83
202409,10509,30,27,3,4,0,4
202409,13040,100,84,16,100,0,100
202409,12637,13,13,0,100,0,100
202409,13744,50,46,4,100,0,100
202501,20873,22,16,6,3,0,3
202409,11626,31,21,10,10,0,10
202409,10042,30,29,1,30,0,30
202501,22709,100,100,0,100,11,89
202501,22029,150,109,41,20,0,20
202409,12713,24,22,2,0,0,0
202501,22222,5,0,5,5,0,5
202501,21322,20,20,0,4,4,0
202501,22220,5,1,4,5,0,5
202409,12657,24,24,0,0,0,0
202409,12367,5,1,4,5,0,5
202501,20759,15,13,2,25,0,25
202501,22501,180,130,50,25,0,25
202409,10099,22,22,0,10,0,10
202409,12623,60,53,7,100,0,100
202501,21672,200,78,122,100,0,100
202409,11211,33,14,19,0,0,0
202501,22593,54,7,47,0,0,0
202501,22900,25,25,0,100,0,100
202501,20154,30,30,0,100,20,80
202501,20456,30,29,1,4,2,2
202501,20491,30,30,0,5,2,3
202409,11793,75,53,22,100,0,100
202501,22184,3,0,3,3,0,3
202501,22522,24,21,3,0,0,0
202409,11450,28,22,6,100,0,100
202501,21310,11,8,3,0,0,0
202501,22143,5,3,2,5,0,5
202501,23041,150,99,51,70,0,70
202409,10721,33,32,1,0,0,0
202501,22557,24,24,0,0,0,0
202501,20358,72,68,4,100,0,100
202409,11661,22,21,1,0,0,0
202409,13077,110,85,25,100,0,100
202501,23747,30,7,23,20,0,20
202409,10108,60,40,20,100,0,100
202409,11193,20,13,7,0,0,0
202501,21179,2,1,1,1,0,1
202409,11718,22,20,2,0,0,0
202409,10672,31,30,1,0,0,0
202501,20731,250,193,57,27,0,27
202501,20364,100,100,0,100,7,93
202501,22717,25,19,6,0,0,0
202409,13968,10,1,9,100,0,100
202409,12068,55,55,0,12,0,12
202409,11876,50,37,13,100,0,100
202501,23027,35,20,15,100,0,100
202501,21517,35,35,0,20,6,14
202409,11968,20,7,13,100,0,100
202501,22532,21,20,1,0,0,0
202501,21160,30,30,0,2,2,0
202409,11857,21,18,3,30,0,30
202409,10334,22,21,1,2,0,2
202409,12837,20,19,1,2,0,2
202409,10244,60,42,18,100,0,100
202501,21748,60,35,25,100,0,100
202409,12728,75,5,70,5,0,5
202501,20026,33,33,0,50,0,50
202409,13144,38,32,6,50,0,50
202501,20709,20,20,0,0,0,0
202501,21655,53,33,20,100,0,100
202409,11439,40,39,1,100,0,100
202501,22173,5,4,1,5,0,5
202501,23982,38,38,0,50,5,45
202501,23901,100,5,95,100,0,100
202409,12658,24,21,3,0,0,0
202501,22881,50,20,30,50,0,50
202409,11562,24,23,1,5,0,5
202501,22218,5,1,4,5,0,5
202501,21644,160,135,25,100,0,100
202501,22305,20,9,11,20,0,20
202501,23176,27,26,1,100,0,100
202501,23061,60,33,27,30,0,30
202501,20315,20,20,0,2,2,0
202409,14240,25,0,25,0,0,0
202501,23904,5,3,2,0,0,0
202409,10742,66,66,0,25,0,25
202409,11162,33,33,0,0,0,0
202501,22444,50,43,7,100,0,100
202409,14239,25,0,25,0,0,0
202409,11775,47,28,19,100,0,100
202501,23907,25,9,16,0,0,0
202409,13310,50,50,0,100,0,100
202409,13838,20,0,20,0,0,0
202409,13036,28,16,12,0,0,0
202409,10832,53,46,7,25,0,25
202501,23879,4,3,1,0,0,0
202409,13007,40,40,0,0,0,0
202501,22193,15,5,10,100,0,100
202409,10060,50,37,13,20,0,20
202409,14125,80,76,4,100,0,100
202409,10371,22,21,1,4,0,4
202409,12980,13,9,4,100,0,100
202409,10988,16,17,-1,3,0,3
202409,12830,20,16,4,2,0,2
202409,14088,12,9,3,0,0,0
202409,11266,32,30,2,30,0,30
202409,11672,22,21,1,0,0,0
202501,21256,40,40,0,40,0,40
202501,21469,50,50,0,100,21,79
202409,11859,80,59,21,100,0,100
202409,11752,40,38,2,100,0,100
202501,22120,125,69,56,100,0,100
202501,23666,20,0,20,0,0,0
202409,12985,140,102,38,10,0,10
202501,22826,45,45,0,25,8,17
202501,23456,12,9,3,0,0,0
202501,20999,30,6,24,0,0,0
202409,11534,20,19,1,5,0,5
202409,13276,2,3,-1,100,0,100
202501,20441,46,46,0,0,0,0
202501,21578,22,12,10,22,0,22
202409,11139,40,26,14,100,0,100
202501,21702,60,23,37,5,0,5
202409,10058,100,92,8,20,0,20
202501,20679,55,29,26,10,0,10
202409,12981,7,5,2,15,0,15
202501,21613,22,22,0,0,0,0
202501,21723,25,25,0,10,2,8
202501,21592,44,44,0,40,3,37
202409,11312,4,4,0,3,0,3
202409,12157,180,160,20,100,0,100
202409,14003,50,48,2,100,0,100
202501,20354,66,66,0,100,23,77
202501,20678,130,97,33,13,0,13
202409,10312,20,19,1,4,0,4
202409,12661,24,24,0,0,0,0
202501,21595,44,44,0,44,13,31
202409,13924,35,12,23,20,0,20
202501,20676,30,29,1,0,0,0
202409,14198,1,1,0,0,0,0
202501,20073,80,79,1,100,0,100
202501,20191,20,20,0,4,3,1
202409,11368,40,33,7,40,0,40
202501,21196,40,40,0,5,2,3
202501,23098,20,11,9,100,0,100
202409,11004,12,12,0,3,0,3
202501,21552,60,60,0,100,2,98
202409,12670,24,24,0,0,0,0
202409,12558,40,26,14,10,0,10
202409,12582,35,30,5,100,0,100
202409,12158,180,160,20,100,0,100
202409,10026,30,30,0,50,0,50
202409,13844,10,5,5,100,0,100
202501,21563,110,101,9,100,0,100
202501,20523,80,64,16,100,0,100
202409,11869,70,27,43,100,0,100
202501,21766,15,13,2,30,0,30
202501,21882,40,27,13,17,0,17
202409,11926,20,23,-3,20,0,20
202409,12435,5,1,4,5,0,5
202501,20636,32,32,0,0,0,0
202501,22155,25,7,18,100,0,100
202409,10338,22,22,0,2,0,2
202501,20976,30,30,0,0,0,0
202409,10256,24,22,2,10,0,10
202409,10549,20,2,18,0,0,0
202501,22596,20,3,17,100,0,100
202501,20623,45,44,1,100,13,87
202501,20287,24,24,0,4,3,1
202409,10050,30,30,0,30,0,30
202501,22457,350,217,133,100,0,100
202501,20345,20,20,0,4,4,0
202501,21717,317,116,201,20,0,20
202409,13003,40,34,6,0,0,0
202501,23921,35,0,35,0,0,0
202409,10035,33,33,0,50,0,50
202501,20273,24,24,0,4,4,0
202409,12123,20,7,13,10,0,10
202501,21338,24,24,0,100,2,98
202501,20963,35,35,0,0,0,0
202409,11132,40,19,21,100,0,100
202409,10190,78,32,46,6,0,6
202409,11572,19,19,0,10,0,10
202501,20720,15,15,0,0,0,0
202409,10468,92,87,5,0,0,0
202501,22834,14,14,0,10,3,7
202501,22103,22,15,7,5,0,5
202501,20829,15,15,0,20,0,20
202409,11134,60,29,31,100,0,100
202501,21728,100,64,36,100,0,100
202501,22259,20,0,20,100,0,100
202409,11769,53,43,10,100,0,100
202501,20764,60,60,0,40,3,37
202409,13964,10,2,8,100,0,100
202409,11080,150,145,5,100,0,100
202501,22196,20,5,15,100,0,100
202501,23939,20,0,20,0,0,0
202501,23705,20,3,17,100,0,100
202501,20738,20,16,4,0,0,0
202409,11873,35,36,-1,100,0,100
202409,11671,22,21,1,0,0,0
202501,21079,10,4,6,0,0,0
202409,11670,22,21,1,0,0,0
202501,20717,15,15,0,0,0,0
202501,20656,40,40,0,25,2,23
202501,20450,30,26,4,4,0,4
202409,11097,75,44,31,100,0,100
202501,21698,60,24,36,5,0,5
202409,12100,60,8,52,30,0,30
202409,13620,20,8,12,100,0,100
202409,10490,30,27,3,4,0,4
202501,20449,30,30,0,4,0,4
202409,12916,35,34,1,0,0,0
202409,12592,35,19,16,20,0,20
202409,11486,15,16,-1,5,0,5
202409,14104,20,10,10,0,0,0
202501,21934,50,50,0,100,3,97
202409,12831,20,20,0,2,0,2
202501,22150,15,6,9,100,0,100
202409,10720,33,30,3,0,0,0
202409,10218,32,32,0,100,0,100
202501,23900,100,6,94,100,0,100
202501,20236,100,0,100,100,0,100
202501,22968,38,36,2,50,0,50
202409,12799,20,16,4,2,0,2
202501,21903,40,40,0,40,0,40
202409,11528,15,13,2,5,0,5
202409,10242,60,57,3,100,0,100
202409,10568,37,34,3,5,0,5
202409,13824,15,9,6,0,0,0
202409,11532,8,0,8,0,0,0
202501,22125,5,3,2,5,0,5
202409,10806,55,46,9,0,0,0
202501,20608,64,64,0,10,0,10
202409,13280,16,13,3,100,0,100
202501,20824,30,24,6,100,0,100
202501,21211,100,24,76,10,0,10
202409,10668,148,143,5,25,0,25
202409,14043,35,23,12,0,0,0
202501,23773,10,2,8,100,0,100
202501,20917,14,7,7,3,0,3
202409,11551,10,3,7,0,0,0
202409,11512,18,17,1,5,0,5
202409,10985,16,16,0,3,0,3
202501,20747,15,5,10,10,0,10
202501,22139,5,0,5,5,0,5
202409,12701,24,22,2,0,0,0
202409,10986,16,0,16,3,0,3
202501,21454,24,24,0,5,0,5
202409,12329,5,1,4,5,0,5
202501,21731,93,81,12,100,0,100
202501,22565,24,18,6,0,0,0
202501,20725,65,65,0,0,0,0
202409,13931,40,22,18,10,0,10
202501,21111,75,5,70,100,0,100
202501,23153,50,23,27,20,0,20
202409,14000,5,0,5,0,0,0
202501,21401,45,45,0,20,5,15
202409,10321,22,22,0,4,0,4
202409,13103,17,25,-8,100,0,100
202409,11182,31,30,1,0,0,0
202409,13760,75,56,19,100,0,100
202409,13726,50,46,4,100,0,100
202409,10471,92,85,7,0,0,0
202409,10079,215,187,28,100,0,100
202501,23103,22,16,6,100,0,100
202409,10065,4,0,4,0,0,0
202409,11713,44,36,8,100,0,100
202501,20210,19,19,0,50,10,40
202409,10826,15,15,0,0,0,0
202501,20632,32,32,0,0,0,0
202501,21605,22,21,1,0,0,0
202501,20664,30,30,0,0,0,0
202409,11221,150,144,6,100,0,100
202409,11677,22,21,1,0,0,0
202501,23827,25,10,15,0,0,0
202501,21259,120,84,36,100,0,100
202409,10376,24,23,1,4,0,4
202409,13936,25,15,10,0,0,0
202409,12854,50,40,10,100,0,100
202501,20528,80,62,18,100,0,100
202409,12343,25,8,17,100,0,100
202501,20025,30,30,0,100,22,78
202501,23495,10,1,9,100,0,100
202501,20740,20,19,1,0,0,0
202501,21026,40,31,9,100,0,100
202501,20129,22,22,0,100,12,88
202409,11995,16,12,4,100,0,100
202501,23095,25,11,14,100,0,100
202409,12304,25,6,19,100,0,100
202409,10755,33,33,0,0,0,0
202409,11571,19,16,3,10,0,10
202501,22743,35,32,3,0,0,0
202501,21206,32,32,0,30,7,23
202501,22559,24,24,0,0,0,0
202409,12307,20,12,8,100,0,100
202409,14228,50,25,25,0,0,0
202409,10628,64,66,-2,10,0,10
202409,14139,22,21,1,20,0,20
202409,10300,24,22,2,4,0,4
202409,12905,100,99,1,100,0,100
202409,11278,32,30,2,30,0,30
202409,11820,53,42,11,5,0,5
202409,12977,20,20,0,10,0,10
202501,22169,5,1,4,0,0,0
202409,13089,80,36,44,100,0,100
202409,10139,22,22,0,100,0,100
202501,20439,92,92,0,0,0,0
202501,20714,15,15,0,0,0,0
202409,12208,50,22,28,10,0,10
202501,20321,20,20,0,2,2,0
202501,20971,150,148,2,100,7,93
202501,20113,25,21,4,100,0,100
202409,11694,110,109,1,100,0,100
202501,20155,30,30,0,100,25,75
202409,13125,22,20,2,30,0,30
202409,10640,64,65,-1,10,0,10
202409,11101,85,70,15,100,0,100
202501,23165,3,3,0,100,1,99
202501,20637,32,32,0,0,0,0
202501,21937,180,153,27,90,0,90
202409,10719,33,32,1,0,0,0
202409,12079,80,59,21,40,0,40
202501,21656,53,53,0,100,7,93
202409,12693,24,24,0,0,0,0
202501,23917,35,0,35,0,0,0
202501,22765,100,100,0,100,70,30
202501,23877,2,1,1,0,0,0
202501,21513,35,35,0,20,4,16
202501,21752,50,47,3,100,0,100
202409,10111,60,51,9,100,0,100
202409,11350,46,44,2,60,0,60
202501,21018,30,19,11,0,0,0
202409,12710,24,22,2,0,0,0
202409,14058,14,14,0,5,0,5
202409,12881,250,134,116,100,0,100
202501,20556,70,18,52,100,0,100
202501,22901,25,23,2,100,0,100
202409,13140,22,20,2,50,0,50
202501,20111,20,20,0,100,5,95
202501,23942,20,0,20,0,0,0
202409,13043,40,23,17,30,0,30
202409,11763,105,97,8,100,0,100
202409,13922,35,18,17,20,0,20
202501,22007,24,16,8,0,0,0
202409,10618,93,52,41,80,0,80
202501,20613,64,63,1,10,0,10
202409,13586,18,5,13,100,0,100
202501,23057,52,45,7,100,0,100
202501,20915,40,34,6,50,0,50
202501,21932,120,119,1,60,2,58
202501,21385,60,64,-4,100,8,92
202409,12319,5,1,4,5,0,5
202501,21188,2,0,2,1,0,1
202409,14069,2,1,1,0,0,0
202409,12078,40,36,4,20,0,20
202409,13589,18,16,2,100,0,100
202409,13150,18,0,18,50,0,50
202501,23505,14,8,6,100,0,100
202501,22895,25,25,0,100,0,100
202409,10910,30,31,-1,5,0,5
202501,20634,32,32,0,0,0,0
202501,21883,40,5,35,17,0,17
202501,21913,40,40,0,100,3,97
202409,10678,31,29,2,0,0,0
202501,21280,23,23,0,4,4,0
202501,21556,22,21,1,0,0,0
202501,21929,200,198,2,100,5,95
202501,21450,24,6,18,5,0,5
202501,20052,50,46,4,20,0,20
202409,10585,12,12,0,2,0,2
202501,23706,60,60,0,100,16,84
202501,22651,20,20,0,2,2,0
202501,21863,25,20,5,100,0,100
202409,11862,100,101,-1,100,0,100
202409,10583,12,12,0,2,0,2
202409,13655,11,10,1,100,0,100
202409,11754,35,23,12,100,0,100
202501,23742,30,21,9,20,0,20
202409,11463,24,24,0,20,0,20
202501,23147,7,12,-5,100,0,100
202409,12052,50,48,2,10,0,10
202409,11138,40,26,14,100,0,100
202409,10837,13,7,6,0,0,0
202501,20734,65,65,0,0,0,0
202409,10151,18,19,-1,100,0,100
202501,21831,25,19,6,10,0,10
202501,23826,25,9,16,0,0,0
202501,21290,19,19,0,4,0,4
202409,11659,22,21,1,0,0,0
202409,10587,80,79,1,100,0,100
202501,21573,88,88,0,88,33,55
202501,21604,22,22,0,0,0,0
202501,20268,24,24,0,4,4,0
202409,13075,25,24,1,100,0,100
202501,22971,55,10,45,50,0,50
202501,23681,10,7,3,100,0,100
202501,22569,24,24,0,0,0,0
202409,12797,20,16,4,2,0,2
202409,10780,90,82,8,25,0,25
202409,12734,60,59,1,0,0,0
202409,12373,5,1,4,5,0,5
202501,20157,30,26,4,100,0,100
202501,21311,11,10,1,0,0,0
202409,12849,50,42,8,100,0,100
202501,23452,18,20,-2,0,0,0
202409,13687,75,57,18,100,0,100
202501,22226,5,2,3,5,0,5
202409,10110,50,36,14,100,0,100
202501,21413,60,46,14,50,0,50
202501,20226,32,32,0,100,4,96
202409,12627,35,32,3,100,0,100
202501,23561,60,60,0,100,0,100
202501,23543,18,7,11,30,0,30
202409,12755,25,25,0,0,0,0
202409,13202,35,30,5,100,0,100
202501,20861,22,21,1,3,0,3
202501,23972,2,0,2,0,0,0
202409,13256,45,37,8,100,0,100
202409,10115,60,46,14,100,0,100
202501,21726,93,93,0,100,15,85
202501,22250,15,5,10,100,0,100
202409,11126,60,17,43,100,0,100
202409,13826,10,1,9,0,0,0
202501,21603,44,44,0,44,2,42
202501,20047,50,50,0,20,15,5
202501,22915,25,24,1,100,0,100
202501,20532,37,37,0,4,1,3
202409,10221,9,9,0,50,0,50
202409,13298,30,30,0,100,0,100
202409,13805,30,24,6,0,0,0
202409,13686,5,1,4,5,0,5
202501,23677,50,50,0,0,0,0
202409,12796,20,19,1,2,0,2
202409,11382,40,40,0,35,0,35
202501,23171,50,50,0,100,0,100
202409,13867,50,13,37,0,0,0
202409,10492,30,28,2,4,0,4
202501,22506,24,24,0,0,0,0
202409,13772,35,30,5,100,0,100
202501,22556,24,24,0,0,0,0
202409,11606,160,142,18,100,0,100
202501,20077,25,7,18,20,0,20
202409,10670,31,31,0,0,0,0
202409,10543,20,9,11,10,0,10
202409,11608,20,19,1,100,0,100
202409,13055,285,263,22,100,0,100
202409,12164,24,22,2,10,0,10
202409,10550,20,13,7,0,0,0
202501,20207,32,32,0,100,10,90
202501,20765,5,1,4,10,0,10
202501,20142,18,18,0,100,13,87
202501,20467,16,16,0,4,4,0
202409,13966,10,1,9,100,0,100
202409,10577,42,42,0,15,0,15
202409,13819,45,39,6,0,0,0
202409,12287,5,1,4,5,0,5
202501,21639,35,18,17,100,0,100
202501,20227,32,32,0,100,4,96
202501,21659,50,20,30,100,0,100
202409,12405,25,8,17,100,0,100
202501,21423,16,12,4,5,0,5
202409,11805,65,42,23,5,0,5
202501,23672,60,60,0,20,6,14
202501,23090,16,13,3,100,0,100
202501,21451,24,18,6,5,0,5
202501,20595,100,35,65,80,0,80
202501,23029,35,33,2,100,0,100
202409,12091,60,60,0,25,0,25
202409,11241,200,161,39,100,0,100
202501,20635,32,32,0,0,0,0
202501,22168,5,1,4,5,0,5
202409,11516,32,34,-2,10,0,10
202409,10156,18,13,5,100,0,100
202409,13858,50,50,0,50,0,50
202409,12042,200,168,32,100,0,100
202409,13200,35,30,5,100,0,100
202409,10944,22,21,1,3,0,3
202409,10478,16,14,2,0,0,0
202501,20494,40,12,28,20,0,20
202501,21449,24,22,2,5,0,5
202501,20596,50,12,38,15,0,15
202409,11569,19,13,6,10,0,10
202409,10647,64,65,-1,10,0,10
202501,23892,1,1,0,0,0,0
202409,10796,17,15,2,0,0,0
202501,20376,85,84,1,100,11,89
202409,10808,115,98,17,25,0,25
202501,23563,75,67,8,100,0,100
202409,11892,20,20,0,100,0,100
202501,20333,18,18,0,4,4,0
202501,20092,22,7,15,10,0,10
202501,21309,22,20,2,0,0,0
202409,11984,30,23,7,100,0,100
202409,13672,105,99,6,100,0,100
202501,22575,70,58,12,0,0,0
202501,21504,20,20,0,100,0,100
202501,22191,25,8,17,100,0,100
202501,21577,22,22,0,0,0,0
202409,11344,47,41,6,100,0,100
202501,22977,18,0,18,30,0,30
202409,11574,19,17,2,10,0,10
202409,11927,20,14,6,20,0,20
202501,22515,24,24,0,0,0,0
202501,20998,30,30,0,0,0,0
202409,11740,24,13,11,100,0,100
202409,13220,39,12,27,20,0,20
202409,12706,24,24,0,0,0,0
202409,13190,25,25,0,0,0,0
202409,13315,50,48,2,100,0,100
202501,21394,15,15,0,5,2,3
202409,13010,100,92,8,25,0,25
202409,10976,28,25,3,3,0,3
202409,12073,55,53,2,12,0,12
202409,10318,22,22,0,4,0,4
202409,11856,93,89,4,100,0,100
202501,20183,13,13,0,0,0,0
202409,10317,250,232,18,100,0,100
202501,21261,23,13,10,23,0,23
202501,21609,22,22,0,0,0,0
202501,20872,100,47,53,50,0,50
202501,20234,24,14,10,10,0,10
202501,22576,45,43,2,5,0,5
202501,21966,25,17,8,12,0,12
202409,10153,18,19,-1,100,0,100
202501,22827,25,25,0,0,0,0
202409,10469,92,85,7,0,0,0
202501,22563,24,24,0,0,0,0
202501,20327,20,20,0,4,4,0
202501,22981,38,38,0,50,16,34
202501,22198,6,1,5,100,0,100
202501,21596,22,22,0,0,0,0
202501,23570,10,5,5,100,0,100
202409,10286,24,24,0,4,0,4
202409,10292,24,24,0,4,0,4
202409,11654,22,22,0,0,0,0
202409,12882,70,54,16,100,0,100
202409,12098,60,57,3,30,0,30
202409,10199,13,12,1,0,0,0
202409,10566,78,66,12,100,0,100
202409,13264,6,5,1,0,0,0
202501,22031,44,25,19,3,0,3
202409,12282,5,2,3,5,0,5
202501,20921,22,17,5,3,0,3
202409,14204,18,17,1,5,0,5
202501,20484,12,12,0,4,3,1
202501,21525,30,13,17,10,0,10
202409,10897,60,26,34,50,0,50
202501,21221,33,33,0,100,10,90
202501,21836,38,38,0,100,3,97
202501,21383,35,19,16,100,0,100
202501,21380,60,57,3,30,0,30
202409,14055,2,1,1,0,0,0
202409,11283,31,30,1,2,0,2
202409,13011,15,11,4,10,0,10
202501,23915,35,0,35,0,0,0
202501,20282,24,24,0,4,4,0
202409,13983,10,2,8,100,0,100
202409,13830,30,24,6,0,0,0
202409,12399,3,0,3,2,0,2
202501,21512,35,35,0,20,3,17
202409,13222,60,59,1,35,0,35
202501,23657,66,64,2,0,0,0
202409,12890,25,25,0,0,0,0
202409,12823,15,13,2,2,0,2
202409,13094,60,64,-4,100,0,100
202409,12303,25,3,22,100,0,100
202501,23986,3,0,3,0,0,0
202409,13935,25,14,11,0,0,0
202501,20599,64,63,1,10,0,10
202501,21082,31,31,0,0,0,0
202409,12001,10,4,6,100,0,100
202409,10101,35,18,17,100,0,100
202501,20402,25,11,14,5,0,5
202409,10462,358,334,24,100,0,100
202501,20340,20,20,0,4,2,2
202409,10243,60,60,0,100,0,100
202409,10217,32,31,1,100,0,100
202501,23971,30,22,8,25,0,25
202501,22738,35,35,0,0,0,0
202409,10185,18,3,15,0,0,0
202501,21561,22,20,2,0,0,0
202501,20218,32,32,0,100,5,95
202501,22538,170,170,0,40,25,15
202409,12884,100,98,2,100,0,100
202409,11607,20,20,0,100,0,100
202409,10200,13,14,-1,0,0,0
202501,20271,24,24,0,4,2,2
202501,22852,20,20,0,3,1,2
202501,20435,46,46,0,0,0,0
202409,12601,20,7,13,20,0,20
202409,11972,23,21,2,100,0,100
202409,12043,200,78,122,100,0,100
202409,12075,180,174,6,35,0,35
202409,10045,31,30,1,30,0,30
202501,20694,30,28,2,0,0,0
202409,13304,45,44,1,100,0,100
202409,12302,5,1,4,5,0,5
202409,11091,75,67,8,100,0,100
202409,11703,22,21,1,0,0,0
202501,22544,24,24,0,0,0,0
202409,10758,185,179,6,18,0,18
202409,12365,5,1,4,5,0,5
202501,21166,30,29,1,2,0,2
202409,12195,50,43,7,10,0,10
202501,21994,30,30,0,10,9,1
202501,20344,66,65,1,100,8,92
202409,10840,10,7,3,10,0,10
202501,20619,64,63,1,10,0,10
202501,22219,5,0,5,5,0,5
202501,21173,30,30,0,2,0,2
202409,12181,44,36,8,5,0,5
202501,22654,20,14,6,2,0,2
202409,14200,3,0,3,0,0,0
202501,21172,30,30,0,2,1,1
202409,11337,33,33,0,100,0,100
202409,12656,24,22,2,0,0,0
202409,11065,35,34,1,0,0,0
202501,21067,35,8,27,50,0,50
202409,11514,75,50,25,50,0,50
202501,22530,24,23,1,0,0,0
202501,22843,80,80,0,10,3,7
202501,20175,18,7,11,0,0,0
202409,13120,38,36,2,50,0,50
202501,20633,32,32,0,0,0,0
202501,21485,10,10,0,15,13,2
202409,10182,18,15,3,0,0,0
202409,11121,30,11,19,0,0,0
202501,20232,24,24,0,10,6,4
202409,10951,32,30,2,3,0,3
202501,23181,12,12,0,100,4,96
202409,10121,25,16,9,100,0,100
202409,10764,21,19,2,0,0,0
202409,13152,18,0,18,30,0,30
202409,12340,50,33,17,100,0,100
202409,10057,50,44,6,100,0,100
202409,13762,150,120,30,100,0,100
202409,10191,13,9,4,0,0,0
202409,11792,45,38,7,100,0,100
202501,20377,48,40,8,100,0,100
202409,12848,60,48,12,100,0,100
202501,22391,40,1,39,0,0,0
202501,21719,65,65,0,10,6,4
202501,22527,30,29,1,0,0,0
202409,12602,50,39,11,20,0,20
202409,12262,80,59,21,100,0,100
202409,14131,1,1,0,0,0,0
202409,12361,34,32,2,100,0,100
202501,20443,30,26,4,0,0,0
202409,14236,10,9,1,10,0,10
202501,22240,3,2,1,3,0,3
202501,23020,35,35,0,100,5,95
202501,20744,60,59,1,0,0,0
202501,21651,53,51,2,100,0,100
202409,12280,5,5,0,5,0,5
202409,12428,5,0,5,5,0,5
202501,21070,45,25,20,100,0,100
202409,10165,30,29,1,100,0,100
202409,11006,12,10,2,3,0,3
202409,10381,24,22,2,4,0,4
202409,12684,158,147,11,33,0,33
202501,20486,10,10,0,4,1,3
202501,23130,15,15,0,100,1,99
202409,11498,35,28,7,50,0,50
202501,22885,25,24,1,100,0,100
202409,11764,5,0,5,50,0,50
202501,20432,46,46,0,0,0,0
202409,10484,30,30,0,4,0,4
202409,12878,317,314,3,100,0,100
202501,20221,32,32,0,100,4,96
202409,12754,68,49,19,100,0,100
202409,11370,44,41,3,40,0,40
202501,23856,15,11,4,100,0,100
202501,22708,100,99,1,100,22,78
202409,12092,60,57,3,25,0,25
202501,20251,180,146,34,100,0,100
202409,10384,20,18,2,4,0,4
202501,22835,35,34,1,0,0,0
202501,20324,20,19,1,2,2,0
202409,11504,16,18,-2,5,0,5
202409,12321,5,1,4,5,0,5
202501,23903,5,5,0,0,0,0
202501,23787,10,6,4,100,0,100
202409,13925,35,22,13,20,0,20
202409,12722,72,67,5,10,0,10
202409,13042,30,16,14,100,0,100
202501,20669,30,27,3,0,0,0
202409,13088,80,79,1,100,0,100
202409,12415,5,4,1,5,0,5
202501,22649,20,9,11,2,0,2
202409,13058,25,25,0,100,0,100
202409,10620,100,67,33,80,0,80
202409,13611,27,27,0,100,0,100
202409,12578,10,2,8,100,0,100
202501,23073,50,16,34,100,0,100
202409,12945,25,25,0,30,0,30
202409,13143,22,15,7,50,0,50
202501,20907,22,11,11,50,0,50
202501,20032,33,33,0,0,0,0
202501,23162,50,38,12,100,0,100
202409,10046,50,44,6,20,0,20
202409,11564,24,21,3,5,0,5
202501,23804,24,21,3,100,0,100
202501,22919,25,20,5,100,0,100
202409,13982,10,3,7,100,0,100
202409,10546,20,13,7,20,0,20
202409,10544,20,8,12,10,0,10
202409,13954,30,24,6,0,0,0
202501,21411,15,8,7,5,0,5
202501,22839,35,35,0,40,14,26
202409,13219,36,29,7,20,0,20
202501,23976,45,45,0,100,3,97
202501,21848,20,16,4,25,0,25
202501,22637,20,20,0,2,0,2
202501,22571,24,12,12,0,0,0
202501,21395,15,15,0,5,3,2
202501,20812,20,20,0,12,4,8
202409,12789,20,20,0,2,0,2
202501,20490,20,3,17,10,0,10
202409,10231,32,31,1,100,0,100
202409,11107,95,88,7,100,0,100
202409,10979,28,26,2,3,0,3
202501,20644,30,30,0,0,0,0
202409,12586,22,12,10,20,0,20
202409,12270,125,93,32,100,0,100
202409,12409,5,0,5,5,0,5
202501,22668,20,16,4,2,0,2
202409,13585,18,9,9,100,0,100
202409,11710,100,96,4,100,0,100
202501,20831,30,20,10,100,0,100
202409,13770,35,28,7,100,0,100
202409,12461,20,11,9,20,0,20
202501,23445,18,5,13,0,0,0
202409,13906,10,5,5,100,0,100
202501,22281,5,0,5,5,0,5
202409,10658,54,48,6,50,0,50
202409,13084,25,19,6,100,0,100
202501,21364,30,30,0,100,12,88
202501,23049,100,99,1,50,20,30
202409,13986,10,7,3,100,0,100
202501,22303,25,12,13,25,0,25
202409,10141,22,22,0,100,0,100
202501,21742,60,59,1,100,6,94
202409,11716,66,59,7,100,0,100
202501,21463,19,19,0,10,3,7
202409,10213,32,32,0,100,0,100
202501,21412,50,28,22,30,0,30
202501,20306,20,20,0,2,2,0
202409,12735,54,54,0,4,0,4
202409,10464,92,90,2,0,0,0
202501,23056,50,26,24,22,0,22
202501,21703,60,24,36,5,0,5
202501,23569,50,41,9,100,0,100
202409,11662,22,17,5,0,0,0
202409,10563,80,81,-1,30,0,30
202501,22162,5,1,4,5,0,5
202409,10192,13,10,3,0,0,0
202409,10649,64,64,0,10,0,10
202501,20874,10,10,0,3,0,3
202409,14007,20,15,5,100,0,100
202501,21692,50,41,9,10,0,10
202409,11167,67,61,6,0,0,0
202409,11489,16,16,0,1,0,1
202501,22590,9,7,2,0,0,0
202501,21591,65,65,0,30,11,19
202501,23673,25,24,1,0,0,0
202409,12929,100,97,3,100,0,100
202501,22234,3,0,3,3,0,3
202501,20362,80,80,0,100,47,53
202409,13034,28,24,4,0,0,0
202501,21892,40,40,0,40,25,15
202501,21505,20,10,10,100,0,100
202501,21619,22,13,9,0,0,0
202501,22452,50,1,49,100,0,100
202501,21868,25,15,10,100,0,100
202501,23767,10,1,9,100,0,100
202501,22056,45,16,29,0,0,0
202409,10686,58,32,26,15,0,15
202409,14225,10,1,9,100,0,100
202409,12716,24,24,0,0,0,0
202501,20534,80,70,10,100,0,100
202409,10146,90,89,1,100,0,100
202409,11965,32,31,1,100,0,100
202409,13650,6,1,5,100,0,100
202501,23444,18,8,10,0,0,0
202501,23142,7,9,-2,100,4,96
202409,10322,22,15,7,4,0,4
202409,12381,5,2,3,5,0,5
202409,10346,22,22,0,2,0,2
202501,23571,60,63,-3,100,0,100
202409,12624,77,51,26,100,0,100
202409,12205,16,13,3,10,0,10
202409,10493,30,30,0,4,0,4
202409,12790,20,17,3,2,0,2
202409,13106,17,25,-8,100,0,100
202501,21366,35,35,0,100,1,99
202501,21999,16,12,4,10,0,10
202501,20085,22,12,10,10,0,10
202501,21991,100,27,73,0,0,0
202501,22267,5,1,4,5,0,5
202409,12451,3,0,3,3,0,3
202501,21143,30,16,14,50,0,50
202409,12915,35,35,0,0,0,0
202409,12902,250,249,1,100,0,100
202501,21001,30,10,20,0,0,0
202409,13869,22,19,3,10,0,10
202409,10087,25,22,3,20,0,20
202501,22720,25,8,17,0,0,0
202409,10188,18,13,5,0,0,0
202501,21470,10,9,1,25,0,25
202409,13308,20,20,0,100,0,100
202409,13250,35,33,2,100,0,100
202501,20027,32,32,0,50,3,47
202501,23733,10,6,4,100,0,100
202501,21388,35,27,8,10,0,10
202501,21765,14,13,1,30,0,30
202409,10511,30,21,9,4,0,4
202501,22126,5,1,4,5,0,5
202501,21832,150,58,92,100,0,100
202501,22159,30,30,0,100,0,100
202501,22924,80,79,1,100,23,77
202501,22705,317,267,50,100,0,100
202409,10397,22,25,-3,0,0,0
202409,12927,100,100,0,100,0,100
202409,10735,31,29,2,0,0,0
202501,23022,35,33,2,100,0,100
202409,10751,115,104,11,11,0,11
202409,10707,220,205,15,25,0,25
202409,10266,70,52,18,100,0,100
202409,12618,30,10,20,100,0,100
202409,12322,5,0,5,5,0,5
202409,12673,24,24,0,0,0,0
202409,10592,80,79,1,100,0,100
202409,10369,22,22,0,4,0,4
202501,21478,40,40,0,100,33,67
202501,23729,10,4,6,100,0,100
202501,20042,30,30,0,15,8,7
202501,23516,11,10,1,10,0,10
202409,10823,7,7,0,10,0,10
202501,21376,16,16,0,5,5,0
202501,22513,24,24,0,0,0,0
202501,20158,200,149,51,20,0,20
202409,10228,32,31,1,100,0,100
202409,13705,30,20,10,0,0,0
202501,21282,23,22,1,4,0,4
202501,22887,25,25,0,100,0,100
202501,21699,60,23,37,5,0,5
202409,13756,60,60,0,100,0,100
202409,12800,20,19,1,2,0,2
202409,13079,25,20,5,100,0,100
202501,21257,40,40,0,40,4,36
202409,10097,22,22,0,10,0,10
202501,21600,22,22,0,0,0,0
202409,10947,32,30,2,3,0,3
202501,21016,55,51,4,100,0,100
202501,20468,16,16,0,4,4,0
202409,11011,28,19,9,3,0,3
202409,12040,45,42,3,20,0,20
202501,21940,60,18,42,20,0,20
202409,10429,50,35,15,15,0,15
202501,23122,250,249,1,50,26,24
202501,20657,80,56,24,10,0,10
202409,13863,39,19,20,50,0,50
202501,21838,28,28,0,100,1,99
202501,22640,20,11,9,2,0,2
202501,21150,32,31,1,30,0,30
202409,10593,80,75,5,100,0,100
202409,11660,22,22,0,0,0,0
202501,21518,43,19,24,10,0,10
202409,10619,100,83,17,80,0,80
202501,22529,24,19,5,0,0,0
202501,21151,32,29,3,30,0,30
202409,10641,64,64,0,10,0,10
202501,23560,25,20,5,100,0,100
202501,23139,15,15,0,100,3,97
202409,11392,25,21,4,4,0,4
202501,20399,30,6,24,10,0,10
202409,12015,200,182,18,100,0,100
202409,12446,3,0,3,3,0,3
202409,12620,60,48,12,100,0,100
202409,13953,30,22,8,0,0,0
202409,11189,66,63,3,0,0,0
202409,12406,15,4,11,100,0,100
202409,11381,40,40,0,35,0,35
202409,11066,35,32,3,0,0,0
202501,23151,50,50,0,100,17,83
202501,22767,100,99,1,100,99,1
202409,10152,18,17,1,100,0,100
202501,22476,45,33,12,100,0,100
202501,21176,20,7,13,10,0,10
202409,12336,3,0,3,0,0,0
202501,21565,22,20,2,0,0,0
202501,20668,30,5,25,0,0,0
202501,21701,53,23,30,5,0,5
202501,20865,165,118,47,50,0,50
202409,10491,30,30,0,4,0,4
202501,23517,25,12,13,100,0,100
202409,11286,31,31,0,2,0,2
202409,11326,33,33,0,100,0,100
202501,21370,16,16,0,5,5,0
202501,20080,93,85,8,100,0,100
202409,12410,20,8,12,100,0,100
202501,21187,2,0,2,1,0,1
202409,13854,53,50,3,50,0,50
202501,23514,6,0,6,0,0,0
202501,21653,53,51,2,100,0,100
202409,13218,39,39,0,20,0,20
202501,20114,25,11,14,100,0,100
202501,21988,32,27,5,5,0,5
202409,11009,12,12,0,3,0,3
202501,22478,60,59,1,20,0,20
202501,23600,25,1,24,0,0,0
202501,21942,180,136,44,90,0,90
202501,21235,150,144,6,80,0,80
202501,21224,32,32,0,100,9,91
202501,20060,3,1,2,0,0,0
202501,22525,190,136,54,100,0,100
202409,11462,24,24,0,20,0,20
202501,23572,60,63,-3,100,0,100
202501,22046,18,18,0,5,5,0
202409,10718,33,29,4,0,0,0
202409,13823,15,10,5,0,0,0
202409,11645,5,5,0,0,0,0
202501,20733,40,26,14,10,0,10
202409,12672,24,21,3,0,0,0
202501,20928,42,35,7,50,0,50
202501,22969,22,22,0,20,0,20
202409,13635,20,10,10,30,0,30
202409,13675,25,12,13,100,0,100
202501,21668,25,14,11,100,0,100
202501,21857,60,44,16,100,0,100
202501,22518,24,22,2,0,0,0
202501,20180,78,77,1,10,0,10
202409,10433,12,5,7,3,0,3
202409,10632,100,85,15,100,0,100
202409,10637,64,61,3,10,0,10
202409,11879,46,39,7,100,0,100
202501,21618,22,15,7,20,0,20
202409,12104,50,45,5,20,0,20
202501,20382,60,45,15,100,0,100
202501,22876,5,0,5,100,0,100
202409,10430,50,35,15,15,0,15
202409,10798,17,16,1,0,0,0
202409,14001,50,51,-1,100,0,100
202501,21538,22,22,0,0,0,0
202409,11619,35,31,4,20,0,20
202501,22197,25,4,21,100,0,100
202501,20903,16,16,0,3,0,3
202501,22209,5,0,5,5,0,5
202501,21969,25,10,15,12,0,12
202501,21017,30,30,0,0,0,0
202409,11520,35,23,12,50,0,50
202409,13299,35,34,1,50,0,50
202409,11652,22,21,1,0,0,0
202501,23084,22,10,12,100,0,100
202501,23898,100,5,95,100,0,100
202501,21445,10,0,10,0,0,0
202409,11711,60,49,11,100,0,100
202409,12442,5,0,5,5,0,5
202409,10525,30,25,5,4,0,4
202409,11070,35,34,1,0,0,0
202409,10209,32,32,0,100,0,100
202501,21371,16,16,0,5,5,0
202501,20721,15,15,0,0,0,0
202501,20375,70,68,2,0,0,0
202409,10275,358,344,14,100,0,100
202501,21169,30,30,0,2,2,0
202501,22231,3,2,1,3,0,3
202501,20729,9,9,0,10,2,8
202501,23749,30,10,20,20,0,20
202501,20649,30,26,4,0,0,0
202409,12885,100,100,0,100,0,100
202409,13261,20,9,11,100,0,100
202409,11319,32,32,0,30,0,30
202501,22433,50,11,39,100,0,100
202409,10722,33,31,2,0,0,0
202409,10095,110,73,37,100,0,100
202501,20931,12,11,1,50,0,50
202409,12083,205,196,9,100,0,100
202409,12209,40,21,19,0,0,0
202501,21650,5,1,4,100,0,100
202409,11089,40,13,27,100,0,100
202501,23820,25,13,12,0,0,0
202501,22293,3,0,3,3,0,3
202409,10487,30,30,0,4,0,4
202501,22587,9,8,1,0,0,0
202409,11794,50,33,17,100,0,100
202409,11019,12,7,5,3,0,3
202409,13918,50,50,0,100,0,100
202501,21015,30,0,30,0,0,0
202501,22432,70,51,19,100,0,100
202501,23852,30,25,5,0,0,0
202409,11508,35,32,3,0,0,0
202409,11074,154,128,26,100,0,100
202409,12194,45,28,17,30,0,30
202409,13722,54,54,0,100,0,100
202409,10522,20,6,14,10,0,10
202409,11567,50,47,3,100,0,100
202501,20682,30,28,2,0,0,0
202501,22867,30,6,24,100,0,100
202409,12453,20,6,14,0,0,0
202409,10540,12,12,0,2,0,2
202501,23784,10,2,8,100,0,100
202501,21933,150,103,47,100,0,100
202409,13857,35,34,1,50,0,50
202501,23647,30,20,10,0,0,0
202501,21546,110,109,1,100,1,99
202501,20038,30,30,0,20,1,19
202409,11464,24,21,3,20,0,20
202501,22942,17,25,-8,100,14,86
202409,10942,22,22,0,3,0,3
202501,20663,30,18,12,0,0,0
202409,11823,53,42,11,5,0,5
202501,23762,10,0,10,100,0,100
202409,13217,36,36,0,20,0,20
202409,12794,20,20,0,2,0,2
202409,12259,180,115,65,100,0,100
202409,10687,60,50,10,25,0,25
202409,12323,5,4,1,5,0,5
202409,14136,40,40,0,20,0,20
202501,20485,12,12,0,4,1,3
202501,20209,32,32,0,50,9,41
202501,20899,16,15,1,3,0,3
202501,23508,14,1,13,100,0,100
202409,11789,36,21,15,0,0,0
202501,22891,25,24,1,100,0,100
202409,10051,30,27,3,30,0,30
202409,10085,25,22,3,20,0,20
202501,21332,20,11,9,4,0,4
202409,12403,20,0,20,10,0,10
202409,11584,10,13,-3,10,0,10
202501,23531,105,79,26,0,0,0
202501,22217,5,2,3,5,0,5
202501,23566,150,120,30,100,0,100
202409,10415,40,0,40,100,0,100
202409,10480,16,10,6,0,0,0
202501,22841,40,40,0,0,0,0
202501,22537,170,169,1,40,25,15
202409,10685,53,49,4,25,0,25
202501,21455,24,24,0,5,0,5
202501,21377,16,16,0,5,5,0
202501,21950,160,114,46,70,0,70
202501,20584,120,119,1,100,5,95
202409,10822,35,34,1,25,0,25
202409,11079,31,30,1,0,0,0
202409,10623,100,58,42,80,0,80
202501,23160,50,45,5,100,0,100
202501,21924,40,10,30,20,0,20
202501,21901,40,38,2,40,0,40
202409,12626,40,29,11,100,0,100
202409,11432,30,30,0,4,0,4
202409,11621,35,24,11,20,0,20
202501,21675,45,29,16,0,0,0
202501,20178,18,18,0,0,0,0
202501,20058,10,7,3,5,0,5
202409,13950,30,22,8,0,0,0
202409,12462,10,1,9,0,0,0
202501,22422,50,37,13,20,0,20
202409,12118,70,38,32,25,0,25
202501,21339,24,24,0,4,2,2
202501,20131,22,22,0,100,10,90
202409,10282,24,23,1,4,0,4
202409,11077,30,27,3,0,0,0
202409,10048,30,29,1,30,0,30
202409,10547,40,23,17,100,0,100
202409,12809,20,10,10,2,0,2
202409,12743,9,8,1,0,0,0
202501,21693,24,22,2,5,0,5
202501,21891,200,199,1,100,3,97
202409,13017,36,30,6,25,0,25
202501,22591,20,17,3,0,0,0
202501,21845,5,0,5,5,0,5
202409,13669,105,104,1,100,0,100
202409,12590,10,4,6,20,0,20
202501,21291,19,19,0,4,1,3
202409,12667,24,23,1,0,0,0
202409,11184,31,31,0,0,0,0
202501,20713,20,17,3,25,0,25
202409,11010,71,68,3,50,0,50
202409,12306,20,12,8,100,0,100
202501,22716,25,25,0,0,0,0
202409,10654,56,55,1,50,0,50
202409,11435,18,12,6,4,0,4
202409,13852,45,44,1,10,0,10
202501,22581,9,9,0,0,0,0
202409,13693,9,9,0,0,0,0
202501,23934,23,23,0,40,1,39
202501,20746,85,54,31,10,0,10
202409,10887,45,45,0,100,0,100
202501,20876,10,9,1,3,0,3
202501,20525,18,18,0,15,2,13
202409,11739,12,12,0,10,0,10
202409,13057,25,26,-1,100,0,100
202409,11929,20,8,12,20,0,20
202409,12315,5,1,4,5,0,5
202501,21885,40,20,20,17,0,17
202409,10179,18,11,7,0,0,0
202501,21329,36,17,19,100,0,100
202409,10299,24,24,0,4,0,4
202409,12297,30,12,18,100,0,100
202409,12038,45,39,6,20,0,20
202409,11570,19,18,1,10,0,10
202501,22757,100,99,1,100,44,56
202409,11811,30,29,1,5,0,5
202409,13192,90,81,9,10,0,10
202501,20821,60,33,27,100,0,100
202501,23680,10,8,2,100,0,100
202409,13651,6,1,5,100,0,100
202409,12748,10,10,0,0,0,0
202501,23515,6,2,4,6,0,6
202501,20039,50,50,0,20,16,4
202409,12255,24,23,1,5,0,5
202501,22707,100,73,27,100,0,100
202409,10347,22,22,0,2,0,2
202501,22127,5,2,3,5,0,5
202409,11388,25,25,0,4,0,4
202409,12765,12,0,12,100,0,100
202501,23450,20,21,-1,0,0,0
202409,10756,33,32,1,0,0,0
202501,20189,30,20,10,100,0,100
202501,22436,40,26,14,20,0,20
202409,13014,38,37,1,0,0,0
202409,13271,75,40,35,100,0,100
202409,13736,40,39,1,100,0,100
202409,12076,40,39,1,20,0,20
202501,22669,50,42,8,100,0,100
202409,12822,15,12,3,2,0,2
202409,12901,250,247,3,100,0,100
202501,23512,6,1,5,6,0,6
202501,22859,20,20,0,0,0,0
202409,11529,40,17,23,50,0,50
202501,20877,100,55,45,50,0,50
202501,21569,66,66,0,66,4,62
202409,12457,15,3,12,100,0,100
202409,10635,64,65,-1,10,0,10
202409,10989,16,15,1,3,0,3
202501,22853,20,19,1,3,0,3
202409,11172,33,32,1,0,0,0
202501,21340,15,0,15,100,0,100
202409,12116,80,73,7,25,0,25
202501,20367,20,20,0,4,4,0
202409,11893,15,14,1,100,0,100
202501,21961,45,23,22,22,0,22
202409,13856,45,45,0,50,0,50
202409,12057,40,35,5,10,0,10
202409,14068,32,32,0,100,0,100
202501,21417,15,15,0,5,1,4
202501,20151,30,29,1,100,23,77
202501,21475,50,50,0,100,2,98
202409,12046,200,181,19,100,0,100
202409,12418,5,1,4,5,0,5
202501,20615,64,63,1,10,0,10
202501,20284,24,24,0,4,4,0
202501,22269,5,0,5,5,0,5
202409,11171,45,40,5,100,0,100
202501,20357,22,22,0,4,0,4
202409,13097,60,62,-2,100,0,100
202409,12378,5,0,5,5,0,5
202501,21236,60,60,0,60,6,54
202409,13001,40,31,9,0,0,0
202501,20086,22,3,19,10,0,10
202501,21168,30,30,0,2,2,0
202501,22570,24,24,0,0,0,0
202501,21415,15,4,11,5,0,5
202409,11354,23,20,3,23,0,23
202501,21788,20,9,11,20,0,20
202409,10675,31,29,2,0,0,0
202409,10295,24,24,0,4,0,4
202409,11179,31,31,0,0,0,0
202409,13970,10,0,10,100,0,100
202409,14070,1,1,0,0,0,0
202501,21075,45,16,29,100,0,100
202409,11724,29,18,11,100,0,100
202409,11335,33,32,1,100,0,100
202409,13975,10,0,10,100,0,100
202501,21606,66,66,0,66,18,48
202409,10201,20,10,10,0,0,0
202409,10711,33,31,2,0,0,0
202501,23486,5,2,3,5,0,5
202501,23134,15,15,0,100,8,92
202409,13789,24,9,15,0,0,0
202409,11735,20,20,0,25,0,25
202501,22290,5,0,5,5,0,5
202501,22546,24,24,0,0,0,0
202409,12935,100,100,0,100,0,100
202501,21389,35,31,4,0,0,0
202501,21407,60,59,1,50,5,45
202409,13595,18,11,7,100,0,100
202409,10804,25,23,2,10,0,10
202501,20228,60,59,1,100,12,88
202409,10622,100,58,42,80,0,80
202409,10676,31,31,0,0,0,0
202501,21072,33,33,0,0,0,0
202409,11223,25,24,1,25,0,25
202409,10665,45,41,4,100,0,100
202501,22957,38,34,4,50,0,50
202409,11868,60,42,18,100,0,100
202409,11717,22,22,0,0,0,0
202501,23125,15,14,1,0,0,0
202501,20741,20,18,2,0,0,0
202409,11108,90,54,36,100,0,100
202409,13246,50,19,31,100,0,100
202409,10043,30,28,2,30,0,30
202501,21938,60,60,0,20,1,19
202501,23093,12,7,5,100,0,100
202409,10574,40,39,1,15,0,15
202501,21420,50,50,0,50,1,49
202501,23447,18,17,1,0,0,0
202501,22598,20,7,13,0,0,0
202501,20313,20,20,0,2,2,0
202409,10361,16,16,0,4,0,4
202409,10564,42,40,2,5,0,5
202501,20546,30,30,0,50,1,49
202409,10747,31,32,-1,0,0,0
202409,11478,35,32,3,50,0,50
202501,21862,27,12,15,100,0,100
202501,22387,40,1,39,0,0,0
202409,11236,66,63,3,0,0,0
202409,12729,8,5,3,0,0,0
202501,22631,20,10,10,2,0,2
202409,13730,12,12,0,100,0,100
202409,11886,68,61,7,100,0,100
202409,11474,18,19,-1,5,0,5
202409,13724,54,54,0,100,0,100
202409,10940,90,82,8,50,0,50
202409,10936,32,30,2,3,0,3
202409,10407,40,20,20,100,0,100
202409,11928,20,8,12,20,0,20
202501,21483,24,2,22,4,0,4
202409,13763,50,42,8,100,0,100
202409,11867,70,41,29,100,0,100
202409,10660,15,14,1,30,0,30
202501,22652,20,17,3,2,0,2
202409,11861,100,75,25,100,0,100
202501,20090,22,5,17,10,0,10
202501,21396,15,15,0,5,4,1
202409,12333,3,1,2,3,0,3
202409,11169,35,31,4,50,0,50
202409,12853,10,8,2,100,0,100
202501,20905,60,60,0,30,5,25
202409,12638,12,4,8,100,0,100
202409,12349,20,5,15,100,0,100
202501,20863,24,20,4,3,0,3
202409,12909,35,33,2,0,0,0
202501,21481,48,8,40,100,0,100
202501,21989,32,30,2,8,1,7
202501,22763,100,99,1,100,96,4
202501,23079,45,44,1,100,22,78
202501,20169,18,8,10,0,0,0
202501,22129,5,0,5,5,0,5
202409,11918,70,58,12,70,0,70
202409,10724,70,51,19,10,0,10
202501,20176,18,17,1,0,0,0
202501,21219,33,33,0,100,18,82
202409,12268,150,138,12,100,0,100
202409,10885,60,51,9,100,0,100
202409,12549,21,18,3,0,0,0
202409,11787,270,195,75,100,0,100
202501,21146,32,32,0,30,0,30
202409,11002,86,68,18,50,0,50
202501,22211,5,1,4,5,0,5
202409,11220,40,25,15,0,0,0
202409,11875,60,26,34,100,0,100
202501,21739,100,95,5,100,0,100
202501,22137,5,2,3,5,0,5
202501,23684,30,30,0,100,0,100
202501,22286,5,0,5,3,0,3
202409,10144,24,22,2,100,0,100
202409,10036,45,39,6,50,0,50
202501,22160,5,2,3,5,0,5
202409,14081,200,184,16,0,0,0
202409,12877,317,316,1,100,0,100
202409,12204,18,16,2,10,0,10
202409,11397,25,18,7,4,0,4
202409,10582,12,12,0,2,0,2
202501,22766,118,43,75,100,0,100
202501,21183,2,0,2,1,0,1
202501,20760,55,52,3,10,0,10
202501,21754,15,13,2,100,0,100
202501,23537,10,7,3,0,0,0
202409,10414,40,20,20,100,0,100
202501,21623,20,19,1,20,0,20
202409,11973,23,22,1,100,0,100
202501,21372,16,16,0,5,5,0
202409,12753,50,51,-1,0,0,0
202501,20137,95,95,0,100,1,99
202409,11020,12,8,4,3,0,3
202501,21998,20,16,4,50,0,50
202501,20666,30,30,0,0,0,0
202409,10834,57,35,22,25,0,25
202409,13263,5,0,5,0,0,0
202501,20074,100,46,54,100,0,100
202501,21580,11,7,4,0,0,0
202501,21548,22,22,0,0,0,0
202501,22974,18,0,18,50,0,50
202409,13104,17,26,-9,100,0,100
202501,23744,30,19,11,20,0,20
202409,12393,3,0,3,3,0,3
202409,10246,100,0,100,100,0,100
202501,20088,22,7,15,10,0,10
202409,10537,9,9,0,0,0,0
202409,14105,20,10,10,0,0,0
202409,13071,25,24,1,100,0,100
202409,10223,32,32,0,100,0,100
202501,20836,45,19,26,100,0,100
202409,12105,160,127,33,70,0,70
202409,12720,24,23,1,0,0,0
202409,13808,30,15,15,0,0,0
202501,20906,60,52,8,30,0,30
202501,21763,16,16,0,100,12,88
202409,10964,46,36,10,50,0,50
202501,22426,20,1,19,15,0,15
202409,13999,300,278,22,0,0,0
202409,12931,100,99,1,100,0,100
202501,22585,45,31,14,100,0,100
202409,14078,200,184,16,0,0,0
202409,10216,32,32,0,100,0,100
202409,11933,20,10,10,20,0,20
202409,10064,10,9,1,5,0,5
202409,10725,84,70,14,10,0,10
202501,20977,30,30,0,0,0,0
202409,10049,30,31,-1,30,0,30
202409,13962,14,11,3,100,0,100
202409,11180,31,31,0,0,0,0
202501,22262,5,4,1,5,0,5
202409,13828,25,0,25,0,0,0
202501,21180,2,1,1,1,0,1
202501,23553,10,11,-1,0,0,0
202409,13859,30,30,0,50,0,50
202409,12842,20,17,3,2,0,2
202501,22960,18,7,11,50,0,50
202409,12917,35,34,1,0,0,0
202501,20884,16,16,0,3,0,3
202409,11727,66,52,14,100,0,100
202409,11663,22,9,13,0,0,0
202501,21486,30,30,0,100,2,98
202501,21255,47,47,0,40,8,32
202501,23745,30,19,11,20,0,20
202501,22058,50,50,0,20,4,16
202409,13952,30,25,5,0,0,0
202501,21895,40,39,1,40,1,39
202409,10224,32,32,0,100,0,100
202501,22274,5,2,3,5,0,5
202409,12604,35,18,17,100,0,100
202501,22131,5,5,0,5,0,5
202409,12312,5,1,4,5,0,5
202409,13207,35,27,8,100,0,100
202409,12654,120,116,4,15,0,15
202409,12179,44,34,10,5,0,5
202409,12801,20,19,1,2,0,2
202501,23143,7,11,-4,100,4,96
202501,21626,25,21,4,25,0,25
202409,10969,1,1,0,2,0,2
202409,13862,31,30,1,50,0,50
202409,10298,24,23,1,4,0,4
202409,10659,50,39,11,50,0,50
202501,22732,100,100,0,100,14,86
202409,13715,45,38,7,100,0,100
202501,23146,7,7,0,100,0,100
202501,21985,130,123,7,50,5,45
202501,21243,23,23,0,23,1,22
202409,12059,40,28,12,10,0,10
202501,20561,40,16,24,100,0,100
202409,13688,75,50,25,100,0,100
202409,11093,30,18,12,0,0,0
202501,20769,5,0,5,10,0,10
202501,22760,100,99,1,100,58,42
202409,14030,1,2,-1,0,0,0
202409,14050,2,1,1,0,0,0
202501,21647,35,15,20,100,0,100
202409,12272,4,0,4,5,0,5
202409,14090,15,14,1,100,0,100
202409,10900,45,29,16,100,0,100
202409,11813,53,42,11,5,0,5
202409,11165,33,32,1,0,0,0
202501,20754,95,95,0,10,10,0
202501,22005,24,21,3,0,0,0
202409,11759,10,9,1,100,0,100
202501,20536,18,15,3,3,0,3
202409,13132,38,30,8,50,0,50
202501,20618,64,68,-4,10,0,10
202409,13942,25,10,15,0,0,0
202409,12041,42,35,7,5,0,5
202409,14035,5,4,1,6,0,6
202501,20497,20,0,20,0,0,0
202409,10037,30,28,2,100,0,100
202409,10264,299,140,159,100,0,100
202409,13221,151,134,17,70,0,70
202409,12685,180,169,11,38,0,38
202409,11730,22,9,13,0,0,0
202501,22539,170,170,0,40,5,35
202409,13212,35,17,18,100,0,100
202409,13145,38,32,6,50,0,50
202501,22288,5,3,2,3,0,3
202501,23556,4,4,0,100,0,100
202409,13673,12,6,6,0,0,0
202501,20091,22,16,6,10,0,10
202501,21247,100,98,2,100,12,88
202501,21074,45,43,2,100,0,100
202409,12557,40,38,2,10,0,10
202501,20084,22,2,20,10,0,10
202501,20460,30,30,0,4,1,3
202501,21068,31,31,0,0,0,0
202409,11281,32,32,0,2,0,2
202501,21996,30,30,0,5,0,5
202409,10459,36,16,20,0,0,0
202501,21198,40,40,0,5,2,3
202409,10909,60,39,21,100,0,100
202409,10198,13,8,5,0,0,0
202501,21152,32,32,0,30,3,27
202409,13825,15,9,6,0,0,0
202501,21418,50,24,26,15,0,15
202409,11336,33,32,1,100,0,100
202409,11633,12,0,12,0,0,0
202409,13761,25,19,6,100,0,100
202409,11391,25,25,0,4,0,4
202409,12587,50,33,17,100,0,100
202409,12155,24,24,0,10,0,10
202409,13905,10,5,5,100,0,100
202501,20544,40,15,25,50,0,50
202501,21335,15,11,4,100,0,100
202501,20462,30,30,0,4,3,1
202501,20164,18,18,0,0,0,0
202409,11814,53,42,11,5,0,5
202501,21482,24,6,18,4,0,4
202501,20071,215,176,39,100,0,100
202501,20686,95,78,17,10,0,10
202409,12691,24,22,2,0,0,0
202501,21073,45,31,14,100,0,100
202409,13257,16,12,4,100,0,100
202501,22897,150,140,10,100,0,100
202409,11978,10,3,7,100,0,100
202409,10793,17,17,0,0,0,0
202409,12636,50,32,18,100,0,100
202501,22146,5,0,5,5,0,5
202409,13230,80,50,30,40,0,40
202409,11088,40,21,19,100,0,100
202501,22214,5,0,5,5,0,5
202501,23118,50,50,0,100,21,79
202501,20132,24,24,0,100,16,84
202501,20912,9,8,1,0,0,0
202409,10066,3,1,2,0,0,0
202409,13893,15,7,8,10,0,10
202409,13293,30,25,5,100,0,100
202409,10278,24,24,0,4,0,4
202409,11270,32,32,0,30,0,30
202501,23597,30,0,30,0,0,0
202409,13860,45,23,22,50,0,50
202409,11294,17,7,10,2,0,2
202501,21962,30,20,10,100,0,100
202409,11817,53,48,5,5,0,5
202409,12438,5,0,5,5,0,5
202409,12546,143,17,126,0,0,0
202501,22628,20,15,5,2,0,2
202409,11426,16,5,11,4,0,4
202501,23085,25,10,15,100,0,100
202501,20021,45,45,0,50,6,44
202501,20878,24,20,4,3,0,3
202501,22583,9,9,0,0,0,0
202501,22567,24,20,4,0,0,0
202409,13229,80,54,26,40,0,40
202409,10952,110,104,6,50,0,50
202501,21802,30,0,30,30,0,30
202501,20767,5,4,1,10,0,10
202501,22875,20,8,12,100,0,100
202501,21515,35,34,1,20,7,13
202409,11396,25,23,2,4,0,4
202501,20739,20,19,1,0,0,0
202409,13038,13,13,0,10,0,10
202501,22762,100,100,0,100,36,64
202409,10889,30,22,8,100,0,100
202501,23670,10,10,0,100,4,96
202409,11655,22,19,3,0,0,0
202409,13018,31,25,6,0,0,0
202409,12707,24,22,2,0,0,0
202501,23889,35,12,23,0,0,0
202409,13275,30,32,-2,100,0,100
202409,12338,3,0,3,3,0,3
202409,13081,25,23,2,100,0,100
202409,13020,31,29,2,0,0,0
202501,20583,300,159,141,100,0,100
202501,21826,30,17,13,10,0,10
202409,13030,110,108,2,25,0,25
202501,22260,30,3,27,100,0,100
202409,10992,16,17,-1,3,0,3
202409,13674,12,10,2,0,0,0
202409,12751,10,11,-1,0,0,0
202501,23683,30,30,0,100,0,100
202501,22429,27,16,11,100,0,100
202501,23961,37,9,28,100,0,100
202501,20031,32,31,1,50,5,45
202409,13193,90,55,35,10,0,10
202409,11318,32,32,0,30,0,30
202409,13062,25,25,0,100,0,100
202409,13911,40,17,23,0,0,0
202409,12694,24,23,1,0,0,0
202409,12358,20,10,10,100,0,100
202501,20017,32,32,0,50,2,48
202409,11304,3,3,0,3,0,3
202501,22961,18,0,18,30,0,30
202409,13939,25,10,15,0,0,0
202501,20672,30,29,1,0,0,0
202501,23443,18,13,5,0,0,0
202409,14183,38,16,22,50,0,50
202501,20281,24,24,0,4,4,0
202501,23902,100,5,95,100,0,100
202501,22216,5,1,4,5,0,5
202409,13096,60,59,1,100,0,100
202501,22238,3,1,2,3,0,3
202409,12058,40,38,2,10,0,10
202409,14025,50,39,11,100,0,100
202409,11118,30,22,8,0,0,0
202501,21948,60,9,51,100,0,100
202409,11113,70,36,34,100,0,100
202501,23788,10,1,9,100,0,100
202409,11133,40,7,33,100,0,100
202501,22511,24,24,0,0,0,0
202501,23091,16,13,3,100,0,100
202409,12369,5,0,5,5,0,5
202501,22976,18,0,18,30,0,30
202501,23129,15,14,1,100,0,100
202501,22746,35,35,0,0,0,0
202501,22161,5,2,3,5,0,5
202501,20728,95,95,0,40,18,22
202409,11469,18,19,-1,5,0,5
202409,11988,65,56,9,100,0,100
202409,12414,10,6,4,100,0,100
202501,22641,110,103,7,100,0,100
202409,12942,25,24,1,100,0,100
202501,20487,10,10,0,4,1,3
202409,14257,1,1,0,0,0,0
202409,10344,22,22,0,2,0,2
202501,20475,20,7,13,10,0,10
202501,21571,22,11,11,0,0,0
202501,21239,60,33,27,60,0,60
202409,11105,90,86,4,100,0,100
202501,21586,23,23,0,0,0,0
202409,11317,32,31,1,30,0,30
202501,22227,5,2,3,5,0,5
202409,10802,20,15,5,10,0,10
202409,10370,22,22,0,4,0,4
202409,13618,15,13,2,100,0,100
202409,12940,100,91,9,100,0,100
202501,20994,30,0,30,0,0,0
202409,13134,38,37,1,50,0,50
202501,20880,10,6,4,3,0,3
202409,11386,299,249,50,100,0,100
202409,13794,24,9,15,0,0,0
202501,21117,50,49,1,100,23,77
202409,13636,20,9,11,5,0,5
202501,20524,18,18,0,15,2,13
202409,10816,70,67,3,0,0,0
202409,11809,55,50,5,5,0,5
202409,11170,33,33,0,0,0,0
202409,12103,52,50,2,20,0,20
202501,22675,70,70,0,100,12,88
202409,12165,24,22,2,10,0,10
202409,12879,317,306,11,100,0,100
202409,11293,32,32,0,2,0,2
202501,21853,20,4,16,100,0,100
202409,13594,18,11,7,100,0,100
202409,12456,25,11,14,25,0,25
202501,21889,200,198,2,100,19,81
202409,12337,3,3,0,3,0,3
202409,14076,60,57,3,100,0,100
202501,20459,30,30,0,4,3,1
202501,20331,54,54,0,100,11,89
202409,13694,5,3,2,100,0,100
202409,10629,64,66,-2,10,0,10
202409,14143,5,4,1,0,0,0
202409,12200,50,19,31,100,0,100
202409,10838,13,11,2,0,0,0
202501,20184,13,12,1,0,0,0
202501,21443,30,0,30,0,0,0
202501,22574,70,59,11,5,0,5
202409,13787,310,303,7,11,0,11
202409,11314,13,6,7,3,0,3
202501,22761,100,100,0,100,51,49
202409,10485,30,30,0,4,0,4
202501,22754,100,100,0,100,42,58
202409,11059,35,35,0,0,0,0
202409,10503,30,17,13,4,0,4
202409,10904,15,9,6,0,0,0
202409,10394,53,43,10,100,0,100
202501,23995,1,1,0,0,0,0
202501,23945,15,0,15,0,0,0
202501,22923,140,106,34,100,0,100
202409,12433,5,0,5,5,0,5
202501,22271,5,0,5,5,0,5
202501,20757,11,11,0,10,2,8
202409,12440,5,0,5,5,0,5
202501,20283,24,24,0,4,4,0
202409,10893,20,2,18,0,0,0
202409,10886,60,59,1,100,0,100
202409,12110,50,20,30,25,0,25
202409,11117,30,30,0,0,0,0
202409,10330,342,330,12,100,0,100
202409,10696,33,22,11,0,0,0
202501,20982,55,20,35,100,0,100
202409,13105,17,25,-8,100,0,100
202409,12631,30,30,0,100,0,100
202409,11190,64,64,0,100,0,100
202409,10978,28,28,0,3,0,3
202501,22042,25,13,12,5,0,5
202409,13046,35,12,23,100,0,100
202409,12983,170,146,24,20,0,20
202409,13907,10,1,9,100,0,100
202501,20693,30,30,0,0,0,0
202409,13233,30,10,20,100,0,100
202409,12386,3,0,3,3,0,3
202409,14082,200,179,21,0,0,0
202501,20923,100,99,1,50,16,34
202409,11217,22,22,0,0,0,0
202409,11937,20,10,10,20,0,20
202501,20233,24,24,0,10,4,6
202409,12594,20,18,2,20,0,20
202501,20201,32,32,0,100,10,90
202409,11920,46,46,0,15,0,15
202501,22844,40,40,0,0,0,0
202501,20253,250,134,116,100,0,100
202501,21189,2,0,2,1,0,1
202501,21058,33,30,3,0,0,0
202501,20537,18,16,2,3,0,3
202501,21669,20,6,14,100,0,100
202501,22516,24,24,0,0,0,0
202409,11332,33,33,0,100,0,100
202409,12293,5,2,3,5,0,5
202409,13314,7,6,1,100,0,100
202501,23937,20,0,20,0,0,0
202501,21904,40,40,0,40,0,40
202501,23063,20,19,1,10,3,7
202409,11962,150,74,76,100,0,100
202501,21409,15,15,0,5,1,4
202409,11509,75,71,4,60,0,60
202501,21521,50,23,27,10,0,10
202501,22055,45,17,28,100,0,100
202409,11023,32,21,11,50,0,50
202409,13959,21,17,4,0,0,0
202409,13024,30,27,3,0,0,0
202501,20716,15,15,0,0,0,0
202409,12448,3,0,3,3,0,3
202501,22849,60,4,56,50,0,50
202501,23743,30,17,13,20,0,20
202409,10648,64,64,0,10,0,10
202409,11531,60,26,34,50,0,50
202501,20204,32,32,0,100,13,87
202501,22549,24,24,0,0,0,0
202501,23858,15,11,4,0,0,0
202409,11688,22,20,2,0,0,0
202501,21231,22,18,4,40,0,40
202501,22233,3,0,3,3,0,3
202501,22674,50,50,0,100,10,90
202501,21276,23,22,1,4,1,3
202501,23106,16,13,3,100,0,100
202409,12745,50,38,12,0,0,0
202501,23985,5,1,4,5,0,5
202409,10704,33,26,7,0,0,0
202501,20083,22,18,4,10,0,10
202409,10389,20,19,1,4,0,4
202409,10716,33,28,5,0,0,0
202409,12211,40,20,20,0,0,0
202501,20240,24,11,13,10,0,10
202409,11436,18,12,6,4,0,4
202501,22723,250,239,11,100,0,100
202409,11307,10,5,5,3,0,3
202501,20166,18,14,4,0,0,0
202501,20237,24,17,7,10,0,10
202409,11305,4,4,0,3,0,3
202501,21930,200,182,18,100,0,100
202501,20918,14,14,0,10,1,9
202409,12803,20,19,1,2,0,2
202501,21959,45,45,0,0,0,0
202409,11523,24,24,0,20,0,20
202409,11230,100,25,75,100,0,100
202409,10694,33,31,2,0,0,0
202409,11445,175,30,145,100,0,100
202409,13050,5,1,4,100,0,100
202501,21764,15,7,8,30,0,30
202501,22285,5,0,5,5,0,5
202501,20380,40,25,15,100,0,100
202501,21477,10,10,0,5,0,5
202501,21597,22,22,0,0,0,0
202501,21544,22,16,6,0,0,0
202501,23180,12,12,0,100,2,98
202409,10529,30,30,0,4,0,4
202409,10781,9,9,0,25,0,25
202501,22838,30,14,16,0,0,0
202409,11005,12,13,-1,3,0,3
202501,20625,45,45,0,100,4,96
202409,11329,33,33,0,100,0,100
202501,21724,20,13,7,0,0,0
202501,21696,53,29,24,10,0,10
202501,20892,20,4,16,3,0,3
202409,13153,18,0,18,30,0,30
202501,20034,30,29,1,20,1,19
202501,21590,55,38,17,20,0,20
202409,13210,25,25,0,100,0,100
202409,13958,30,25,5,0,0,0
202501,23119,30,27,3,100,0,100
202501,23923,35,0,35,0,0,0
202409,10569,78,66,12,100,0,100
202409,11357,80,76,4,80,0,80
202501,21064,35,19,16,50,0,50
202409,11185,31,31,0,0,0,0
202501,22435,60,43,17,20,0,20
202409,11773,53,51,2,100,0,100
202409,14085,25,10,15,0,0,0
202409,11342,40,35,5,40,0,40
202409,12184,151,110,41,30,0,30
202501,20225,32,32,0,100,4,96
202409,11476,140,135,5,100,0,100
202409,11806,15,8,7,5,0,5
202409,11657,22,15,7,0,0,0
202409,11526,15,14,1,5,0,5
202501,22775,25,25,0,30,25,5
202501,20379,24,16,8,4,0,4
202501,23051,50,50,0,25,1,24
202409,10041,30,28,2,30,0,30
202409,12633,30,27,3,0,0,0
202501,22277,5,0,5,5,0,5
202501,22753,100,100,0,100,96,4
202409,10164,30,27,3,100,0,100
202409,10746,31,32,-1,0,0,0
202501,20050,60,60,0,30,30,0
202409,10366,20,20,0,4,0,4
202501,22819,30,30,0,0,0,0
202409,12607,30,6,24,20,0,20
202409,11935,30,9,21,30,0,30
202409,10472,92,61,31,0,0,0
202501,22638,20,18,2,2,0,2
202501,21461,50,50,0,100,14,86
202501,20651,30,18,12,0,0,0
202501,23660,75,63,12,0,0,0
202501,21059,33,31,2,0,0,0
202501,22724,250,247,3,100,10,90
202501,20029,30,30,0,50,2,48
202501,20706,20,20,0,0,0,0
202501,20973,30,30,0,0,0,0
202409,11055,300,278,22,100,0,100
202409,12444,3,1,2,3,0,3
202501,22893,25,25,0,100,0,100
202501,20930,60,39,21,50,0,50
202501,21212,150,72,78,10,0,10
202409,10738,31,26,5,0,0,0
202501,21666,25,22,3,10,0,10
202501,22445,35,16,19,30,0,30
202409,12113,70,51,19,35,0,35
202501,22938,60,59,1,100,31,69
202501,23558,60,63,-3,100,0,100
202409,13598,12,10,2,100,0,100
202409,11702,22,20,2,0,0,0
202409,12437,5,0,5,5,0,5
202409,10502,30,28,2,4,0,4
202501,21382,30,29,1,5,0,5
202409,10789,120,75,45,14,0,14
202409,11479,215,203,12,100,0,100
202501,20267,24,24,0,4,4,0
202501,23783,10,2,8,100,0,100
202409,10532,10,10,0,4,0,4
202409,10025,32,31,1,50,0,50
202409,10737,31,31,0,0,0,0
202501,20187,13,13,0,0,0,0
202409,11213,18,18,0,0,0,0
202409,10671,31,31,0,0,0,0
202501,21249,40,39,1,40,4,36
202409,11577,54,54,0,100,0,100
202501,21499,60,58,2,15,0,15
202409,13849,50,32,18,0,0,0
202501,22874,15,4,11,100,0,100
202501,20540,80,65,15,100,0,100
202501,20239,24,24,0,10,9,1
202409,10709,180,146,34,18,0,18
202501,20106,45,28,17,100,0,100
202409,11389,25,24,1,4,0,4
202501,21284,23,23,0,4,4,0
202501,21906,40,38,2,40,0,40
202501,21033,40,34,6,100,0,100
202501,20911,9,9,0,3,0,3
202409,10120,25,6,19,100,0,100
202409,10551,20,2,18,0,0,0
202409,12056,40,35,5,10,0,10
202409,13768,60,58,2,100,0,100
202501,23631,150,137,13,0,0,0
202409,12360,28,28,0,100,0,100
202409,12097,180,115,65,90,0,90
202501,21360,140,140,0,100,4,96
202409,12852,50,47,3,100,0,100
202501,20397,50,19,31,10,0,10
202409,10695,33,33,0,0,0,0
202501,22929,40,38,2,100,0,100
202409,11429,16,2,14,4,0,4
202409,11414,299,223,76,100,0,100
202409,10579,80,80,0,100,0,100
202409,13940,25,10,15,0,0,0
202409,11741,30,19,11,100,0,100
202501,23926,80,80,0,100,42,58
202501,23174,12,12,0,100,4,96
202409,11178,31,31,0,0,0,0
202501,21921,40,39,1,20,0,20
202501,20230,100,0,100,100,0,100
202501,23731,10,5,5,100,0,100
202409,13695,4,4,0,100,0,100
202409,12697,24,23,1,0,0,0
202501,23908,110,44,66,100,0,100
202409,10114,60,38,22,100,0,100
202409,10434,12,12,0,3,0,3
202501,20724,45,23,22,10,0,10
202409,13070,25,25,0,100,0,100
202409,12999,127,127,0,25,0,25
202501,21226,33,32,1,100,14,86
202501,23658,66,62,4,0,0,0
202409,10595,37,37,0,15,0,15
202409,12207,22,10,12,5,0,5
202501,22151,50,12,38,100,0,100
202501,21646,28,10,18,100,0,100
202501,20100,20,20,0,10,5,5
202409,11546,35,7,28,20,0,20
202409,12407,50,8,42,100,0,100
202501,20617,64,63,1,10,0,10
202409,13912,40,18,22,0,0,0
202501,20338,18,18,0,4,4,0
202409,11239,35,36,-1,100,0,100
202501,22603,12,9,3,100,0,100
202409,13765,50,41,9,100,0,100
202501,22728,200,199,1,100,62,38
202409,10754,33,32,1,0,0,0
202409,12938,100,93,7,100,0,100
202409,10379,24,22,2,4,0,4
202409,11325,33,33,0,100,0,100
202501,21014,30,2,28,0,0,0
202409,11309,5,5,0,3,0,3
202409,10615,36,37,-1,50,0,50
202501,20929,40,39,1,50,0,50
202501,22562,24,24,0,0,0,0
202501,23771,10,0,10,100,0,100
202409,11192,31,30,1,0,0,0
202409,12250,24,23,1,5,0,5
202501,23506,14,7,7,100,0,100
202501,23167,18,18,0,100,7,93
202409,12434,5,0,5,5,0,5
202501,21747,60,40,20,100,0,100
202501,21424,32,15,17,10,0,10
202409,11816,60,46,14,5,0,5
202409,13861,30,30,0,50,0,50
202409,13596,50,35,15,100,0,100
202501,20531,80,73,7,100,0,100
202501,20827,30,30,0,100,4,96
202501,23453,18,11,7,0,0,0
202501,21720,30,23,7,10,0,10
202409,11533,40,19,21,50,0,50
202501,22304,15,3,12,15,0,15
202501,22475,50,25,25,100,0,100
202409,10289,24,24,0,4,0,4
202501,21887,200,200,0,100,13,87
202409,10082,75,70,5,100,0,100
202501,23154,20,16,4,100,0,100
202409,10743,8,7,1,10,0,10
202501,20699,15,3,12,10,0,10
202409,10408,30,33,-3,100,0,100
202501,21317,32,32,0,100,11,89
202501,21349,24,24,0,20,20,0
202501,23940,20,0,20,0,0,0
202501,23880,2,1,1,0,0,0
202409,11729,22,20,2,0,0,0
202501,22289,5,0,5,5,0,5
202501,23182,20,19,1,100,0,100
202409,11237,44,43,1,0,0,0
202409,12883,100,100,0,100,0,100
202409,13223,60,32,28,35,0,35
202501,22261,30,22,8,30,0,30
202501,20238,24,21,3,10,0,10
202409,10365,20,20,0,4,0,4
202409,10167,30,25,5,100,0,100
202409,12907,100,99,1,100,0,100
202501,21890,200,199,1,100,82,18
202501,21244,60,60,0,40,24,16
202501,20600,64,68,-4,10,0,10
202501,21025,20,4,16,100,0,100
202409,14142,22,22,0,10,0,10
202501,22483,12,10,2,0,0,0
202501,20453,30,25,5,4,0,4
202501,22108,22,18,4,5,0,5
202409,13727,32,32,0,100,0,100
202501,20444,30,30,0,0,0,0
202501,22039,60,38,22,0,0,0
202409,14091,31,31,0,0,0,0
202409,11124,30,10,20,0,0,0
202409,11482,15,15,0,5,0,5
202501,21995,30,30,0,10,8,2
202501,22937,60,60,0,100,27,73
202501,23824,25,6,19,0,0,0
202409,11555,24,17,7,5,0,5
202409,10766,21,18,3,0,0,0
202409,13039,9,5,4,10,0,10
202501,20139,20,18,2,100,0,100
202409,12150,144,143,1,50,0,50
202409,14004,50,24,26,100,0,100
202501,22533,24,23,1,0,0,0
202501,23789,10,2,8,100,0,100
202501,20161,18,18,0,0,0,0
202501,21321,20,20,0,4,4,0
202409,11374,26,27,-1,22,0,22
202501,21963,60,30,30,100,0,100
202409,13758,25,20,5,100,0,100
202409,11000,82,81,1,50,0,50
202501,22592,54,10,44,100,0,100
202501,22871,20,10,10,100,0,100
202501,20366,20,20,0,100,5,95
202409,13717,45,33,12,100,0,100
202501,20463,30,30,0,4,4,0
202501,21107,100,53,47,100,0,100
202501,22719,25,25,0,0,0,0
202501,20349,20,20,0,4,4,0
202409,11234,33,33,0,0,0,0
202501,22040,50,42,8,10,0,10
202409,12588,20,14,6,100,0,100
202409,11279,32,32,0,2,0,2
202501,20548,30,15,15,100,0,100
202501,22667,20,3,17,2,0,2
202409,12251,24,21,3,5,0,5
202409,11228,25,23,2,25,0,25
202501,22830,25,25,0,0,0,0
202501,21402,22,22,0,5,0,5
202501,21057,33,33,0,0,0,0
202501,20909,42,31,11,0,0,0
202409,12974,60,53,7,30,0,30
202409,11709,60,51,9,100,0,100
202501,21361,110,109,1,100,15,85
202501,21425,35,21,14,50,0,50
202409,12458,20,7,13,100,0,100
202501,23179,18,18,0,100,20,80
202501,23076,30,26,4,100,0,100
202409,14229,80,76,4,0,0,0
202409,10180,30,21,9,0,0,0
202409,12825,15,11,4,2,0,2
202501,23534,12,6,6,0,0,0
202501,20913,9,5,4,3,0,3
202501,22519,24,18,6,0,0,0
202409,13249,75,59,16,100,0,100
202409,11921,50,47,3,15,0,15
202409,12600,28,15,13,100,0,100
202409,13253,20,20,0,100,0,100
202501,20688,95,95,0,25,16,9
202501,21506,20,20,0,100,0,100
202409,14168,60,34,26,60,0,60
202501,20981,30,30,0,0,0,0
202501,20642,30,30,0,0,0,0
202409,11756,35,12,23,100,0,100
202409,10352,22,22,0,2,0,2
202409,10708,3,3,0,25,0,25
202501,22206,5,1,4,5,0,5
202501,22903,25,23,2,100,0,100
202409,10938,32,31,1,3,0,3
202409,10906,45,13,32,100,0,100
202501,21467,19,3,16,10,0,10
202501,20261,200,200,0,100,26,74
202501,20200,32,31,1,100,11,89
202409,13270,25,6,19,100,0,100
202501,21881,200,85,115,90,0,90
202409,11164,33,32,1,0,0,0
202409,13793,105,70,35,10,0,10
202409,10392,20,14,6,4,0,4
202409,10667,140,131,9,25,0,25
202409,11970,20,2,18,100,0,100
202501,20081,80,42,38,100,0,100
202409,11102,60,46,14,100,0,100
202409,11689,22,22,0,0,0,0
202409,11696,22,22,0,0,0,0
202409,13613,280,255,25,100,0,100
202409,12054,40,40,0,10,0,10
202409,13972,10,2,8,100,0,100
202501,20049,50,50,0,20,19,1
202501,22733,100,99,1,100,14,86
202501,21894,40,38,2,40,14,26
202409,10506,30,16,14,4,0,4
202501,22239,5,4,1,3,0,3
202409,11401,150,114,36,100,0,100
202409,11932,30,18,12,30,0,30
202409,12125,50,41,9,25,0,25
202409,12071,55,44,11,12,0,12
202409,11791,45,34,11,100,0,100
202501,23040,150,150,0,70,2,68
202501,21232,50,49,1,35,3,32
202409,11127,30,17,13,0,0,0
202501,22294,3,1,2,3,0,3
202501,20535,80,67,13,100,0,100
202409,10621,100,79,21,80,0,80
202409,10380,24,21,3,4,0,4
202501,21077,31,30,1,0,0,0
202409,12016,200,131,69,100,0,100
202501,21326,54,22,32,100,0,100
202501,21167,30,30,0,2,2,0
202409,13265,16,14,2,100,0,100
202409,10105,53,50,3,100,0,100
202501,21954,45,42,3,22,0,22
202501,20867,90,48,42,50,0,50
202409,12124,15,3,12,10,0,10
202501,20825,45,31,14,100,0,100
202501,23080,45,44,1,100,8,92
202501,20810,30,25,5,100,0,100
202501,22089,110,109,1,100,0,100
202409,12093,60,47,13,25,0,25
202501,20677,30,29,1,0,0,0
202409,10507,180,146,34,100,0,100
202409,10088,25,16,9,20,0,20
202409,11622,35,22,13,20,0,20
202501,22550,24,23,1,0,0,0
202409,11891,18,18,0,100,0,100
202501,20147,22,22,0,100,0,100
202409,13127,22,20,2,30,0,30
202409,13692,10,11,-1,0,0,0
202409,13063,25,26,-1,100,0,100
202501,20871,24,16,8,3,0,3
202409,11865,48,50,-2,100,0,100
202501,22625,20,20,0,2,0,2
202501,21745,50,50,0,100,6,94
202409,10702,33,33,0,0,0,0
202501,20972,30,30,0,0,0,0
202409,12375,5,1,4,5,0,5
202409,10032,33,31,2,50,0,50
202501,20680,30,29,1,0,0,0
202409,11525,15,10,5,5,0,5
202501,20477,150,41,109,20,0,20
202409,10999,16,16,0,3,0,3
202409,12948,25,25,0,30,0,30
202409,13124,22,22,0,30,0,30
202501,21912,40,40,0,40,0,40
202409,10790,154,139,15,10,0,10
202501,20723,150,67,83,15,0,15
202501,23619,67,65,2,0,0,0
202501,23535,12,10,2,0,0,0
202501,23998,2,2,0,0,0,0
202501,22911,25,25,0,100,0,100
202409,10096,22,17,5,10,0,10
202409,12277,5,0,5,5,0,5
202501,20555,12,4,8,10,0,10
202409,10531,68,28,40,100,0,100
202409,10935,90,76,14,50,0,50
202501,21222,33,33,0,100,10,90
202409,11375,22,19,3,22,0,22
202409,12834,20,6,14,2,0,2
202501,22756,100,100,0,100,96,4
202501,21864,20,20,0,100,13,87
202501,21620,44,43,1,20,0,20
202409,13273,12,8,4,100,0,100
202409,11232,119,112,7,0,0,0
202409,13128,22,22,0,30,0,30
202501,21144,32,32,0,30,10,20
202501,21503,20,20,0,100,1,99
202409,13154,22,16,6,50,0,50
202501,22884,238,232,6,100,0,100
202409,12356,20,21,-1,100,0,100
202409,12162,24,23,1,10,0,10
202501,21575,22,22,0,0,0,0
202409,14026,26,26,0,100,0,100
202501,22099,299,125,174,100,0,100
202409,14057,13,13,0,5,0,5
202409,13279,16,13,3,100,0,100
202409,10981,34,19,15,50,0,50
202501,20141,18,16,2,100,0,100
202501,22670,50,50,0,100,2,98
202501,22179,5,0,5,5,0,5
202409,11443,50,21,29,4,0,4
202409,13657,14,8,6,100,0,100
202409,12334,3,0,3,3,0,3
202409,10820,100,81,19,25,0,25
202409,11964,41,39,2,100,0,100
202409,10438,20,11,9,5,0,5
202409,13019,31,24,7,0,0,0
202501,20446,30,27,3,0,0,0
202409,12167,24,11,13,5,0,5
202501,22964,22,21,1,50,1,49
202501,21909,40,26,14,40,0,40
202501,21453,24,16,8,5,0,5
202409,12548,21,19,2,0,0,0
202501,21333,20,11,9,4,0,4
202409,10287,24,24,0,4,0,4
202501,22505,24,24,0,0,0,0
202501,22037,80,74,6,20,0,20
202501,20326,80,80,0,100,45,55
202409,13689,40,29,11,100,0,100
202409,13203,35,35,0,100,0,100
202409,11563,24,15,9,5,0,5
202501,20445,30,30,0,0,0,0
202409,10039,45,43,2,10,0,10
202501,21902,40,40,0,40,0,40
202501,22758,100,100,0,100,40,60
202409,13840,20,0,20,0,0,0
202409,12088,230,228,2,100,0,100
202501,23849,30,25,5,0,0,0
202501,23916,35,0,35,0,0,0
202409,13245,45,37,8,100,0,100
202409,11691,44,42,2,100,0,100
202409,12928,100,100,0,100,0,100
202501,23913,35,0,35,0,0,0
202501,20559,10,10,0,5,5,0
202409,13157,38,33,5,50,0,50
202501,21214,33,33,0,100,39,61
202409,13258,16,12,4,100,0,100
202409,12665,24,23,1,0,0,0
202409,12718,24,15,9,0,0,0
202409,12893,25,24,1,0,0,0
202501,22930,40,22,18,100,0,100
202409,14250,6,3,3,0,0,0
202501,22597,20,7,13,100,0,100
202501,20474,16,16,0,4,4,0
202409,12094,50,48,2,25,0,25
202409,11129,80,44,36,100,0,100
202409,12732,22,19,3,0,0,0
202501,21319,16,16,0,4,2,2
202501,20748,45,45,0,25,13,12
202501,22043,60,36,24,10,0,10
202501,20040,50,50,0,30,13,17
202409,11428,16,0,16,4,0,4
202409,10997,16,17,-1,3,0,3
202501,22188,3,0,3,0,0,0
202409,11967,28,20,8,100,0,100
202501,21473,50,46,4,100,0,100
202501,22635,20,20,0,2,1,1
202501,23676,25,8,17,100,0,100
202409,12593,20,6,14,20,0,20
202501,22287,5,0,5,5,0,5
202409,11556,24,12,12,5,0,5
202501,20464,30,30,0,4,3,1
202409,12019,50,49,1,20,0,20
202501,22225,5,2,3,5,0,5
202501,23145,60,60,0,50,12,38
202409,10208,32,32,0,100,0,100
202501,22060,20,0,20,10,0,10
202501,23663,20,0,20,0,0,0
202409,10712,33,27,6,0,0,0
202501,22992,38,38,0,50,7,43
202501,21427,24,24,0,20,15,5
202409,11130,75,20,55,100,0,100
202501,21229,22,22,0,40,0,40
202409,10089,110,54,56,100,0,100
202409,11322,100,39,61,10,0,10
202501,23927,25,25,0,100,23,77
202501,22192,25,6,19,100,0,100
202409,11786,175,146,29,100,0,100
202409,10943,22,20,2,3,0,3
202501,22883,50,20,30,50,0,50
202501,20093,75,45,30,100,0,100
202409,11790,60,53,7,100,0,100
202501,21968,20,20,0,6,4,2
202409,10219,30,16,14,50,0,50
202409,11356,51,42,9,40,0,40
202501,20681,30,30,0,0,0,0
202409,10119,30,20,10,100,0,100
202409,13251,35,24,11,100,0,100
202409,10538,12,11,1,2,0,2
202409,10782,83,82,1,25,0,25
202501,23924,35,0,35,0,0,0
202409,10972,30,29,1,3,0,3
202501,21674,45,15,30,100,0,100
202409,10815,23,20,3,0,0,0
202409,12828,110,70,40,100,0,100
202501,23177,12,12,0,100,2,98
202409,13044,90,59,31,100,0,100
202409,12049,40,35,5,10,0,10
202501,20275,24,23,1,4,4,0
202501,21835,38,37,1,100,5,95
202409,10578,41,41,0,15,0,15
202409,11878,50,27,23,100,0,100
202409,12411,30,16,14,30,0,30
202409,12900,250,247,3,100,0,100
202409,10301,24,23,1,4,0,4
202409,10939,86,74,12,50,0,50
202409,11629,30,20,10,5,0,5
202409,11194,66,64,2,0,0,0
202501,22035,150,109,41,20,0,20
202501,22230,3,0,3,3,0,3
202501,20483,9,8,1,0,0,0
202501,20609,64,63,1,10,0,10
202409,12102,60,61,-1,20,0,20
202501,22032,44,24,20,3,0,3
202409,10100,22,5,17,10,0,10
202409,10059,50,43,7,20,0,20
202409,10652,50,42,8,50,0,50
202501,21323,40,9,31,20,0,20
202409,12247,24,24,0,5,0,5
202409,12120,60,47,13,20,0,20
202501,22016,32,28,4,10,1,9
202501,20980,30,30,0,0,0,0
202501,22979,22,21,1,50,2,48
202409,11417,18,16,2,4,0,4
202501,22165,5,1,4,5,0,5
202501,22531,24,22,2,0,0,0
202409,11848,40,39,1,10,0,10
202409,11125,30,2,28,0,0,0
202501,20087,110,59,51,100,0,100
202409,11994,25,23,2,100,0,100
202409,12284,5,0,5,5,0,5
202409,12121,30,22,8,15,0,15
202501,21847,10,8,2,100,0,100
202501,21804,30,8,22,30,0,30
202501,21541,22,20,2,0,0,0
202409,12290,5,3,2,5,0,5
202501,21837,25,25,0,100,9,91
202409,11589,30,29,1,20,0,20
202501,20145,24,20,4,100,0,100
202409,11582,75,57,18,100,0,100
202409,11096,30,22,8,0,0,0
202501,21915,40,31,9,40,0,40
202409,10305,24,24,0,4,0,4
202409,14109,20,0,20,0,0,0
202501,22636,20,19,1,2,0,2
202501,22882,50,20,30,50,0,50
202501,22045,10,7,3,100,0,100
202501,20603,100,47,53,100,0,100
202501,22123,5,0,5,5,0,5
202501,21581,66,63,3,66,0,66
202409,12838,20,18,2,2,0,2
202409,12795,20,18,2,2,0,2
202501,23482,17,18,-1,15,0,15
202501,23601,30,23,7,0,0,0
202501,22057,40,33,7,30,0,30
202409,12430,5,0,5,5,0,5
202501,23850,30,22,8,0,0,0
202501,21670,175,146,29,100,0,100
202409,12397,3,0,3,3,0,3
202501,20673,30,30,0,0,0,0
202501,21369,160,160,0,50,44,6
202409,11106,90,18,72,100,0,100
202409,13085,80,81,-1,100,0,100
202409,12939,100,100,0,100,0,100
202409,11668,22,21,1,0,0,0
202501,21735,60,58,2,100,0,100
202409,10147,65,57,8,100,0,100
202501,21800,30,16,14,30,0,30
202501,21553,88,78,10,88,0,88
202409,12744,9,5,4,0,0,0
202501,23060,60,60,0,30,1,29
202501,21120,200,85,115,100,0,100
202409,11333,33,33,0,100,0,100
202409,13277,3,3,0,100,0,100
202409,13148,18,1,17,30,0,30
202501,20318,20,20,0,2,2,0
202501,20868,22,20,2,3,0,3
202501,20208,32,32,0,100,13,87
202409,11656,22,20,2,0,0,0
202409,10038,45,41,4,50,0,50
202409,12541,47,46,1,0,0,0
202409,13086,80,79,1,100,0,100
202409,10288,24,24,0,4,0,4
202409,11466,18,18,0,5,0,5
202409,11362,49,45,4,40,0,40
202501,21665,50,35,15,100,0,100
202409,11081,55,22,33,100,0,100
202501,22600,20,11,9,100,0,100
202409,11980,6,3,3,20,0,20
202409,10067,13,11,2,0,0,0
202501,21008,75,40,35,100,0,100
202409,10340,22,22,0,2,0,2
202409,13022,30,30,0,0,0,0
202501,21572,22,22,0,0,0,0
202501,20110,30,30,0,100,2,98
202501,22028,150,58,92,20,0,20
202501,21148,32,32,0,30,8,22
202409,11485,15,16,-1,5,0,5
202409,10741,35,10,25,10,0,10
202501,20594,100,73,27,80,0,80
202501,23688,50,0,50,100,0,100
202409,11732,100,95,5,100,0,100
202409,12035,230,200,30,100,0,100
202409,10342,22,21,1,2,0,2
202501,21787,25,12,13,0,0,0
202409,11274,32,26,6,30,0,30
202501,21145,32,32,0,30,5,25
202409,11395,25,24,1,4,0,4
202409,11963,43,43,0,100,0,100
202409,12932,100,98,2,100,0,100
202409,11340,22,22,0,100,0,100
202409,11231,60,6,54,50,0,50
202501,22107,22,22,0,5,0,5
202501,22978,22,22,0,50,1,49
202501,22041,25,14,11,0,0,0
202409,12605,48,29,19,100,0,100
202409,13845,10,8,2,100,0,100
202501,23184,65,1,64,100,0,100
202501,20620,64,61,3,10,0,10
202501,22599,35,9,26,100,0,100
202409,12851,25,18,7,100,0,100
202409,11116,30,8,22,0,0,0
202409,11726,22,6,16,0,0,0
202409,10383,180,167,13,100,0,100
202501,22659,20,8,12,2,0,2
202409,12345,15,3,12,20,0,20
202409,11022,46,41,5,50,0,50
202501,21640,30,24,6,100,0,100
202409,12712,24,22,2,0,0,0
202409,14238,25,23,2,0,0,0
202501,22540,30,29,1,0,0,0
202409,11131,20,4,16,100,0,100
202501,21078,10,1,9,0,0,0
202409,12906,100,100,0,100,0,100
202501,23036,90,71,19,40,0,40
202409,11676,22,21,1,0,0,0
202409,13677,25,25,0,0,0,0
202409,10255,24,8,16,10,0,10
202501,22003,150,87,63,100,0,100
202501,21278,23,22,1,4,0,4
202501,21071,33,33,0,0,0,0
202501,21926,80,57,23,40,0,40
202501,21918,200,137,63,70,0,70
202409,14163,15,14,1,15,0,15
202501,22500,299,242,57,35,0,35
202409,12050,40,38,2,10,0,10
202501,22047,18,18,0,10,10,0
202409,11431,40,38,2,100,0,100
202409,10830,35,26,9,25,0,25
202409,11503,16,17,-1,5,0,5
202409,10713,33,33,0,0,0,0
202501,23766,10,7,3,100,0,100
202501,23532,105,97,8,0,0,0
202409,10171,18,15,3,0,0,0
202501,23689,50,0,50,100,0,100
202409,10148,110,106,4,100,0,100
202409,11112,60,22,38,100,0,100
202409,13056,200,193,7,100,0,100
202501,22223,5,0,5,5,0,5
202501,22441,35,34,1,30,0,30
202501,22207,5,0,5,5,0,5
202409,12273,4,0,4,5,0,5
202501,21750,45,45,0,100,0,100
202501,22601,20,17,3,5,0,5
202409,12305,60,43,17,100,0,100
202501,22156,60,37,23,100,0,100
202501,22851,30,30,0,50,12,38
202501,23062,50,27,23,25,0,25
202409,10410,90,45,45,100,0,100
202501,23679,50,39,11,100,0,100
202409,12347,20,15,5,20,0,20
202409,11491,16,16,0,0,0,0
202501,20404,40,16,24,0,0,0
202409,11271,31,30,1,30,0,30
202409,10662,45,41,4,100,0,100
202409,12074,54,49,5,12,0,12
202409,12368,5,1,4,5,0,5
202409,14080,60,52,8,0,0,0
202501,21893,40,40,0,40,16,24
202501,21165,30,30,0,2,1,1
202501,21457,24,9,15,5,0,5
202501,23028,35,15,20,100,0,100
202501,22256,30,13,17,30,0,30
202409,12704,24,21,3,0,0,0
202409,13133,38,38,0,50,0,50
202501,21897,40,40,0,40,20,20
202409,10409,30,33,-3,100,0,100
202501,20035,30,30,0,20,0,20
202409,13191,25,24,1,100,0,100
202501,22443,10,4,6,100,0,100
202501,22656,20,19,1,2,0,2
202409,10958,32,32,0,3,0,3
202501,23074,50,40,10,100,0,100
202501,21567,22,21,1,0,0,0
202409,12276,5,2,3,5,0,5
202409,10967,1,0,1,2,0,2
202409,10431,50,34,16,15,0,15
202501,21867,50,6,44,100,0,100
202501,21368,120,118,2,100,52,48
202501,20553,20,20,0,100,0,100
202409,13855,35,31,4,50,0,50
202501,20698,90,90,0,40,6,34
202409,12455,25,13,12,100,0,100
202409,12206,22,18,4,10,0,10
202409,10107,45,41,4,100,0,100
202409,13059,25,16,9,100,0,100
202409,14122,15,0,15,0,0,0
202501,21694,53,38,15,0,0,0
202409,12892,25,25,0,0,0,0
202409,11017,30,24,6,3,0,3
202409,10297,24,24,0,4,0,4
202409,11067,35,33,2,0,0,0
202501,22676,30,29,1,100,18,82
202501,20755,25,16,9,10,0,10
202409,11701,88,85,3,100,0,100
202501,22739,35,34,1,0,0,0
202409,14006,32,30,2,100,0,100
202409,12764,12,9,3,100,0,100
202501,22030,44,26,18,3,0,3
202501,21722,35,35,0,20,2,18
202501,23643,30,22,8,0,0,0
202501,22428,25,9,16,15,0,15
202501,22427,15,0,15,100,0,100
202409,10965,4,1,3,10,0,10
202501,23941,20,0,20,0,0,0
202409,10740,136,131,5,13,0,13
202501,20173,18,17,1,0,0,0
202409,10329,22,22,0,4,0,4
202501,20983,55,55,0,100,2,98
202501,20138,20,16,4,100,0,100
202501,20660,55,40,15,15,0,15
202409,11240,35,33,2,100,0,100
202501,21648,30,18,12,50,0,50
202409,14045,20,8,12,0,0,0
202501,21109,50,24,26,30,0,30
202409,13208,35,35,0,100,0,100
202409,10617,60,45,15,50,0,50
202501,23899,60,0,60,100,0,100
202409,13729,50,50,0,100,0,100
202409,10387,20,19,1,4,0,4
202409,10829,20,18,2,10,0,10
202409,11423,30,21,9,0,0,0
202409,11849,30,19,11,10,0,10
202501,21354,18,18,0,5,3,2
202409,11346,64,60,4,60,0,60
202501,20749,35,35,0,10,1,9
202409,10436,12,11,1,3,0,3
202409,12810,20,16,4,2,0,2
202501,21579,11,6,5,0,0,0
202501,22195,20,12,8,20,0,20
202409,11299,3,3,0,3,0,3
202501,22857,20,20,0,0,0,0
202501,20351,20,20,0,4,4,0
202501,20591,100,47,53,80,0,80
202409,13872,40,37,3,10,0,10
202409,12832,20,15,5,2,0,2
202409,11177,33,33,0,0,0,0
202409,10519,16,15,1,16,0,16
202409,11025,24,19,5,50,0,50
202409,13162,38,25,13,50,0,50
202409,10794,17,17,0,0,0,0
202501,22873,60,22,38,100,0,100
202409,11007,12,0,12,3,0,3
202409,11768,53,47,6,100,0,100
202409,12383,5,2,3,5,0,5
202409,10345,22,22,0,2,0,2
202409,10222,32,31,1,100,0,100
202501,22106,22,22,0,5,0,5
202409,12152,24,24,0,10,0,10
202409,10674,31,31,0,0,0,0
202409,13169,22,18,4,30,0,30
202501,22836,35,35,0,0,0,0
202409,12275,5,1,4,5,0,5
202409,13807,30,23,7,0,0,0
202501,21002,86,86,0,100,13,87
202501,20715,15,15,0,0,0,0
202501,21784,50,49,1,50,0,50
202409,12574,80,53,27,20,0,20
202409,13654,6,2,4,100,0,100
202501,20403,20,18,2,10,0,10
202501,23541,15,14,1,100,0,100
202501,22666,20,13,7,2,0,2
202501,20279,24,24,0,4,4,0
202501,20328,20,20,0,4,4,0
202501,20889,120,56,64,50,0,50
202501,23044,50,50,0,20,1,19
202501,21390,35,33,2,0,0,0
202501,22555,24,24,0,0,0,0
202409,10995,16,14,2,3,0,3
202501,22254,20,7,13,100,0,100
202501,21566,22,22,0,0,0,0
202409,12170,80,71,9,50,0,50
202501,20458,30,30,0,4,3,1
202409,10542,10,9,1,4,0,4
202409,11280,32,32,0,2,0,2
202409,11075,31,26,5,0,0,0
202501,20622,50,40,10,50,0,50
202501,21540,110,108,2,100,0,100
202409,10112,74,64,10,100,0,100
202501,21629,25,14,11,0,0,0
202501,21524,35,9,26,5,0,5
202501,20260,280,253,27,100,0,100
202409,12127,20,13,7,100,0,100
202409,11219,22,21,1,0,0,0
202501,22899,25,25,0,100,0,100
202409,10002,35,11,24,20,0,20
202409,14119,15,0,15,0,0,0
202501,22898,150,120,30,100,0,100
202501,21274,50,33,17,0,0,0
202501,22535,24,13,11,0,0,0
202501,22450,35,21,14,20,0,20
202501,23582,150,139,11,0,0,0
202409,12419,5,2,3,5,0,5
202501,21729,75,75,0,100,2,98
202409,12144,80,80,0,60,0,60
202409,10293,24,24,0,4,0,4
202409,13072,25,24,1,100,0,100
202501,20433,92,92,0,0,0,0
202501,20054,50,50,0,20,0,20
202501,22270,5,2,3,5,0,5
202409,10406,100,67,33,100,0,100
202409,10959,32,31,1,3,0,3
202501,23557,150,123,27,50,0,50
202501,22926,80,68,12,100,0,100
202501,20526,18,18,0,15,0,15
202501,22244,3,0,3,2,0,2
202501,23736,10,8,2,30,0,30
202409,11658,110,90,20,100,0,100
202409,10698,33,29,4,0,0,0
202501,21695,53,29,24,10,0,10
202409,10749,31,33,-2,0,0,0
202409,12342,25,8,17,25,0,25
202501,21324,20,9,11,4,0,4
202501,23911,35,0,35,0,0,0
202409,12997,100,76,24,10,0,10
202501,22437,35,23,12,20,0,20
202501,22935,60,60,0,100,36,64
202409,10792,17,17,0,0,0,0
202501,20276,24,24,0,4,4,0
202501,20762,55,55,0,40,14,26
202501,22468,35,35,0,100,2,98
202501,20551,35,29,6,100,0,100
202409,13069,25,25,0,100,0,100
202501,21602,22,17,5,0,0,0
202409,11062,35,34,1,0,0,0
202409,13971,10,2,8,100,0,100
202409,13294,30,29,1,100,0,100
202501,23682,30,28,2,100,0,100
202409,13159,38,37,1,50,0,50
202409,13292,250,249,1,100,0,100
202409,12726,24,24,0,0,0,0
202501,20752,49,49,0,40,27,13
202501,22012,80,33,47,0,0,0
202409,12577,35,25,10,20,0,20
202501,22842,40,40,0,0,0,0
202501,22022,32,32,0,5,1,4
202501,21535,88,88,0,40,3,37
202501,21841,20,0,20,100,0,100
202501,20365,100,87,13,100,0,100
202501,22237,3,0,3,3,0,3
202501,21570,22,18,4,0,0,0
202501,22774,25,25,0,30,30,0
202409,12087,215,211,4,100,0,100
202409,11427,16,8,8,4,0,4
202409,11497,90,91,-1,50,0,50
202501,23882,3,1,2,3,0,3
202501,20552,20,20,0,100,0,100
202409,10479,16,16,0,0,0,0
202501,21010,90,33,57,100,0,100
202409,13759,75,67,8,100,0,100
202409,10090,22,17,5,10,0,10
202501,21801,30,0,30,30,0,30
202409,11393,25,24,1,4,0,4
202501,21334,35,2,33,100,0,100
202409,12674,24,24,0,0,0,0
202409,11708,60,56,4,100,0,100
202501,21428,24,20,4,20,0,20
202409,10326,22,22,0,4,0,4
202409,11137,43,11,32,0,0,0
202409,12402,20,5,15,3,0,3
202409,10094,22,0,22,10,0,10
202501,21928,80,80,0,40,2,38
202501,21400,60,45,15,50,0,50
202409,11341,22,22,0,100,0,100
202501,20886,16,16,0,3,1,2
202409,13737,44,44,0,100,0,100
202409,12077,40,38,2,20,0,20
202409,11355,23,17,6,23,0,23
202501,20427,358,341,17,100,0,100
202501,22194,50,4,46,100,0,100
202501,20046,100,100,0,20,18,2
202409,11461,75,67,8,100,0,100
202501,20360,20,20,0,4,4,0
202409,13740,65,35,30,0,0,0
202409,10890,30,25,5,100,0,100
202501,23448,18,16,2,0,0,0
202501,21599,22,22,0,0,0,0
202501,21076,66,56,10,0,0,0
202409,12326,5,0,5,5,0,5
202501,21021,30,16,14,0,0,0
202409,12111,25,20,5,12,0,12
202409,12062,40,11,29,10,0,10
202501,22902,25,22,3,100,0,100
202409,14089,20,9,11,0,0,0
202501,20639,145,132,13,14,0,14
202409,10061,60,59,1,30,0,30
202409,11287,20,12,8,2,0,2
202501,20374,150,150,0,100,8,92
202501,21162,30,27,3,2,0,2
202409,10627,70,51,19,70,0,70
202409,13915,53,48,5,100,0,100
202409,10458,45,44,1,10,0,10
202409,10586,80,80,0,100,0,100
202501,22212,5,0,5,5,0,5
202501,21949,160,121,39,70,0,70
202409,13842,120,70,50,100,0,100
202409,11136,43,11,32,100,0,100
202409,11094,30,11,19,0,0,0
202409,13865,30,17,13,0,0,0
202501,20177,18,10,8,0,0,0
202409,11415,66,35,31,100,0,100
202409,10497,30,29,1,4,0,4
202501,20671,30,27,3,0,0,0
202409,12919,35,32,3,0,0,0
202409,10524,150,125,25,100,0,100
202409,13307,12,12,0,10,0,10
202409,11496,45,35,10,50,0,50
202409,10575,80,79,1,100,0,100
202501,22462,40,40,0,100,1,99
202409,10680,31,30,1,0,0,0
202501,22780,25,25,0,30,29,1
202501,20900,16,6,10,3,0,3
202409,11015,30,23,7,3,0,3
202501,22480,40,12,28,100,0,100
202409,12762,24,23,1,100,0,100
202409,12072,55,36,19,12,0,12
202409,10937,18,15,3,3,0,3
202409,11493,16,15,1,1,0,1
202501,20712,130,130,0,40,24,16
202409,11373,23,15,8,23,0,23
202501,22152,30,12,18,0,0,0
202409,12663,24,24,0,0,0,0
202409,10539,12,12,0,2,0,2
202409,12176,151,115,36,30,0,30
202409,10001,25,23,2,40,0,40
202501,21916,40,35,5,40,0,40
202501,23536,25,12,13,0,0,0
202409,12115,40,37,3,20,0,20
202501,20368,40,32,8,100,0,100
202501,21452,24,21,3,5,0,5
202409,10726,30,23,7,0,0,0
202409,10081,75,63,12,100,0,100
202501,20252,317,317,0,100,24,76
202409,13963,10,2,8,100,0,100
202501,20586,100,47,53,80,0,80
202501,20350,20,20,0,4,4,0
202501,21943,60,60,0,35,0,35
202501,20481,9,9,0,0,0,0
202501,20355,22,21,1,4,4,0
202501,20348,100,100,0,100,23,77
202501,21121,31,31,0,0,0,0
202409,13831,24,9,15,0,0,0
202501,20150,30,28,2,100,15,85
202501,22020,150,98,52,30,0,30
202409,12791,20,18,2,2,0,2
202501,23038,30,28,2,15,0,15
202501,22660,20,12,8,2,0,2
202501,20662,20,20,0,10,0,10
202409,11285,32,32,0,2,0,2
202501,22542,24,24,0,0,0,0
202409,10996,16,8,8,3,0,3
202409,10895,60,51,9,100,0,100
202409,12949,25,25,0,100,0,100
202409,10494,30,30,0,4,0,4
202501,22278,5,2,3,5,0,5
202501,23999,1,1,0,0,0,0
202409,10508,30,29,1,4,0,4
202409,11273,32,30,2,30,0,30
202409,11188,8,4,4,0,0,0
202501,22534,24,19,5,0,0,0
202409,12366,5,0,5,5,0,5
202409,11291,32,30,2,2,0,2
202501,20130,22,22,0,100,8,92
202501,20925,30,30,0,3,3,0
202409,11822,53,42,11,5,0,5
202501,20768,15,0,15,10,0,10
202409,10362,16,9,7,4,0,4
202501,20590,100,53,47,80,0,80
202501,21792,20,0,20,20,0,20
202501,22872,100,18,82,100,0,100
202409,10835,6,4,2,10,0,10
202409,11444,150,143,7,100,0,100
202409,13278,16,13,3,100,0,100
202501,22644,20,18,2,2,0,2
202409,13123,18,4,14,30,0,30
202501,23890,21,21,0,100,2,98
202501,21312,64,38,26,100,0,100
202409,11573,19,14,5,10,0,10
202409,10254,24,17,7,10,0,10
202501,20089,22,22,0,10,1,9
202501,21624,30,30,0,30,3,27
202409,12081,80,77,3,40,0,40
202501,23735,10,3,7,100,0,100
202501,21738,60,32,28,100,0,100
202501,22744,35,34,1,0,0,0
202501,23099,15,9,6,100,0,100
202501,21955,45,33,12,100,0,100
202409,12740,9,9,0,0,0,0
202501,20893,20,4,16,3,0,3
202409,13033,28,26,2,0,0,0
202409,10812,23,20,3,0,0,0
202501,21023,75,41,34,100,0,100
202501,21355,18,18,0,5,2,3
202501,20274,24,24,0,4,4,0
202409,10611,250,250,0,100,0,100
202409,10892,60,45,15,100,0,100
202409,10941,22,19,3,3,0,3
202501,22520,24,24,0,0,0,0
202501,23876,4,2,2,0,0,0
202501,20206,32,32,0,100,8,92
202409,11559,24,21,3,5,0,5
202409,10567,37,32,5,5,0,5
202409,11343,44,37,7,100,0,100
202501,21403,23,23,0,5,5,0
202409,13978,10,6,4,100,0,100
202501,21099,20,9,11,25,0,25
202409,11682,22,21,1,0,0,0
202501,20102,20,20,0,10,1,9
202501,20146,18,18,0,100,1,99
202409,12669,24,22,2,0,0,0
202409,12396,3,2,1,3,0,3
202409,10279,24,24,0,4,0,4
202409,11471,18,17,1,5,0,5
202501,21313,20,20,0,4,1,3
202409,13064,25,22,3,100,0,100
202409,12941,100,99,1,100,0,100
202501,23779,10,5,5,100,0,100
202409,10240,32,32,0,100,0,100
202501,21744,40,40,0,100,3,97
202409,12947,25,17,8,30,0,30
202409,12705,24,19,5,0,0,0
202409,10186,18,16,2,0,0,0
202501,20094,36,36,0,30,4,26
202501,21302,22,19,3,4,0,4
202409,10374,24,22,2,4,0,4
202409,14110,20,8,12,0,0,0
202409,12106,175,169,6,70,0,70
202501,21997,90,90,0,50,19,31
202409,11420,37,32,5,100,0,100
202409,10154,18,15,3,100,0,100
202409,13291,250,250,0,100,0,100
202409,10197,39,34,5,5,0,5
202501,21328,40,15,25,100,0,100
202409,12331,5,0,5,5,0,5
202501,21397,36,21,15,50,0,50
202409,12556,40,40,0,10,0,10
202501,20438,46,46,0,0,0,0
202501,20621,50,27,23,50,0,50
202501,21797,31,31,0,30,0,30
202409,11265,32,29,3,30,0,30
202501,22470,35,35,0,100,8,92
202409,13974,10,3,7,100,0,100
202409,13194,90,54,36,10,0,10
202501,22158,20,9,11,100,0,100
202501,22962,18,2,16,30,0,30
202409,10950,32,28,4,3,0,3
202409,10954,150,128,22,50,0,50
202409,11922,25,23,2,25,0,25
202409,11242,42,43,-1,0,0,0
202501,22015,32,29,3,10,1,9
202409,12300,50,11,39,100,0,100
202501,23837,50,50,0,100,4,96
202501,21393,15,15,0,5,4,1
202409,10161,31,29,2,100,0,100
202501,23477,15,13,2,0,0,0
202501,22655,110,86,24,100,0,100
202501,20689,20,19,1,10,0,10
202501,21240,60,30,30,60,0,60
202409,11858,110,89,21,100,0,100
202501,22134,5,2,3,5,0,5
202409,12625,30,11,19,100,0,100
202409,11284,32,30,2,2,0,2
202501,21114,66,62,4,0,0,0
202409,13078,25,23,2,100,0,100
202409,10215,32,32,0,100,0,100
202501,21727,200,182,18,100,4,96
202501,23574,75,58,17,100,0,100
202501,20153,30,30,0,100,0,100
202501,20128,22,22,0,100,9,91
202409,12044,200,192,8,100,0,100
202501,23685,30,32,-2,100,0,100
202501,22401,40,1,39,0,0,0
202409,12447,3,1,2,3,0,3
202501,21069,31,31,0,0,0,0
202501,20211,13,13,0,50,0,50
202409,11292,31,30,1,2,0,2
202501,21759,46,46,0,100,5,95
202501,22541,24,24,0,0,0,0
202501,22745,35,31,4,0,0,0
202409,11585,15,10,5,5,0,5
202409,12185,27,26,1,10,0,10
202501,23828,25,8,17,0,0,0
202409,11477,75,72,3,100,0,100
202409,10461,358,231,127,100,0,100
202409,10945,234,220,14,50,0,50
202409,11430,16,5,11,4,0,4
202501,22502,80,80,0,20,1,19
202501,23132,15,15,0,100,0,100
202409,11880,50,36,14,100,0,100
202409,12664,24,24,0,0,0,0
202409,10463,299,182,117,100,0,100
202501,20332,18,18,0,4,4,0
202501,22721,25,25,0,0,0,0
202409,11681,22,22,0,0,0,0
202501,22703,317,316,1,100,8,92
202409,11547,35,31,4,100,0,100
202409,10102,35,21,14,100,0,100
202501,21404,32,16,16,10,0,10
202501,21993,90,90,0,50,21,29
202409,10155,18,17,1,100,0,100
202409,12460,5,1,4,5,0,5
202501,23960,60,60,0,100,0,100
202409,10693,33,31,2,0,0,0
202409,14042,5,1,4,0,0,0
202409,11013,28,23,5,3,0,3
202501,22439,20,1,19,15,0,15
202501,23575,75,62,13,100,0,100
202501,23818,25,14,11,0,0,0
202409,13216,180,116,64,70,0,70
202409,12621,75,74,1,100,0,100
202409,11690,22,21,1,0,0,0
202409,12395,5,4,1,3,0,3
202409,12912,35,34,1,0,0,0
202501,23544,18,1,17,50,0,50
202501,22044,45,45,0,100,20,80
202501,20492,140,109,31,25,0,25
202409,13969,10,3,7,100,0,100
202501,20290,24,24,0,4,4,0
202501,20372,120,120,0,100,37,63
202409,11588,22,22,0,100,0,100
202409,10031,33,33,0,100,0,100
202409,13933,25,16,9,0,0,0
202501,22208,5,1,4,5,0,5
202501,21589,23,22,1,0,0,0
202501,23530,105,98,7,0,0,0
202501,23102,2,1,1,100,0,100
202501,21508,20,10,10,100,0,100
202501,21952,60,60,0,32,9,23
202501,20742,20,20,0,0,0,0
202501,22132,5,0,5,5,0,5
202409,12392,3,1,2,3,0,3
202501,23120,80,79,1,30,11,19
202501,20329,20,20,0,4,4,0
202409,10258,30,28,2,100,0,100
202501,21484,30,30,0,50,24,26
202501,22180,5,2,3,5,0,5
202501,22052,35,34,1,50,0,50
202409,12027,50,36,14,20,0,20
202501,22182,5,3,2,5,0,5
202409,11686,22,22,0,0,0,0
202501,20690,30,30,0,0,0,0
202409,10265,78,52,26,100,0,100
202501,22430,35,19,16,30,0,30
202409,13021,71,66,5,10,0,10
202409,12581,25,23,2,20,0,20
202409,12295,5,0,5,100,0,100
202409,13771,35,30,5,100,0,100
202501,20356,22,22,0,4,3,1
202501,23455,50,35,15,0,0,0
202409,13272,12,12,0,100,0,100
202501,23479,20,8,12,100,0,100
202409,13809,30,23,7,0,0,0
202501,21960,60,30,30,30,0,30
202501,21378,16,16,0,5,4,1
202501,21379,16,16,0,5,3,2
202409,12154,24,24,0,10,0,10
202501,21554,22,22,0,0,0,0
202501,21614,20,20,0,20,2,18
202409,10631,64,60,4,10,0,10
202409,10633,100,29,71,100,0,100
202501,22972,18,0,18,30,0,30
202409,11610,20,19,1,100,0,100
202501,20962,245,198,47,100,0,100
202501,20243,15,0,15,100,0,100
202501,23470,27,27,0,100,4,96
202501,21444,10,0,10,100,0,100
202409,10576,83,83,0,100,0,100
202409,13209,30,17,13,100,0,100
202501,20683,30,27,3,0,0,0
202501,22201,5,0,5,5,0,5
202409,11566,150,98,52,100,0,100
202409,13804,30,23,7,0,0,0
202409,11008,12,11,1,3,0,3
202409,10723,33,25,8,0,0,0
202501,22715,25,25,0,0,0,0
202409,10684,65,62,3,25,0,25
202409,11087,40,36,4,100,0,100
202501,22308,20,10,10,20,0,20
202409,13060,25,25,0,100,0,100
202409,12459,20,3,17,100,0,100
202501,20470,16,16,0,4,4,0
202501,21736,60,24,36,100,0,100
202501,22984,38,38,0,50,44,6
202501,22471,30,24,6,100,0,100
202501,23800,300,278,22,0,0,0
202409,11016,30,24,6,3,0,3
202409,11212,5,2,3,0,0,0
202409,12449,3,0,3,3,0,3
202409,11515,35,19,16,50,0,50
202409,13619,15,9,6,100,0,100
202409,13593,18,20,-2,100,0,100
202501,20115,10,5,5,100,0,100
202501,22958,38,38,0,50,4,46
202409,11565,24,14,10,5,0,5
202501,22664,20,20,0,2,0,2
202501,21035,30,7,23,0,0,0
202501,20756,44,44,0,40,24,16
202409,12454,20,4,16,0,0,0
202501,23552,60,26,34,100,0,100
202501,20703,20,20,0,0,0,0
202409,13623,17,18,-1,15,0,15
202409,11808,20,18,2,10,0,10
202501,23052,180,180,0,70,0,70
202501,21305,66,48,18,100,0,100
202409,11888,47,34,13,100,0,100
202409,10150,20,13,7,100,0,100
202409,12018,200,148,52,50,0,50
202501,21063,33,33,0,0,0,0
202501,22837,35,35,0,0,0,0
202409,10055,50,50,0,20,0,20
202409,13311,45,42,3,100,0,100
202409,10625,100,55,45,80,0,80
202409,14244,40,20,20,20,0,20
202409,13067,25,23,2,100,0,100
202409,13987,10,1,9,100,0,100
202409,12034,50,47,3,10,0,10
202501,21013,30,29,1,0,0,0
202409,11883,60,26,34,100,0,100
202409,12332,5,3,2,5,0,5
202409,10106,45,41,4,100,0,100
202409,13817,25,20,5,0,0,0
202409,10679,31,28,3,0,0,0
202409,11976,5,0,5,0,0,0
202409,11870,15,6,9,30,0,30
202501,20024,30,30,0,50,20,30
202409,11210,10,4,6,0,0,0
202409,12281,5,0,5,5,0,5
202501,22059,25,0,25,5,0,5
202409,12109,43,32,11,30,0,30
202409,10975,28,26,2,3,0,3
202501,23078,20,18,2,100,0,100
202409,11548,30,28,2,100,0,100
202409,11227,25,24,1,25,0,25
202409,12427,5,2,3,5,0,5
202501,20969,35,23,12,0,0,0
202409,12350,25,5,20,100,0,100
202501,20659,55,54,1,10,0,10
202409,13984,10,3,7,100,0,100
202409,10375,120,111,9,100,0,100
202409,11999,35,27,8,100,0,100
202501,22213,5,2,3,5,0,5
202409,10040,150,144,6,30,0,30
202409,12730,66,61,5,5,0,5
202409,13129,22,16,6,30,0,30
202501,20530,80,61,19,100,0,100
202501,20493,40,40,0,0,0,0
202409,10501,30,19,11,4,0,4
202409,10358,16,12,4,4,0,4
202501,21951,60,57,3,30,0,30
202409,12325,5,0,5,5,0,5
202409,11290,32,32,0,2,0,2
202409,12829,20,13,7,2,0,2
202409,11609,20,19,1,100,0,100
202409,13092,40,36,4,100,0,100
202501,21275,225,220,5,100,0,100
202501,21611,44,44,0,44,14,30
202501,23893,50,42,8,100,0,100
202409,11481,90,91,-1,50,0,50
202409,10142,24,24,0,100,0,100
202409,12841,20,19,1,0,0,0
202409,10363,54,61,-7,100,0,100
202501,22548,24,24,0,0,0,0
202409,14060,3,1,2,3,0,3
202409,11083,60,53,7,0,0,0
202501,22854,20,15,5,3,0,3
202409,11072,35,30,5,0,0,0
202409,12037,45,41,4,20,0,20
202501,20059,4,0,4,0,0,0
202409,13820,75,62,13,0,0,0
202501,21164,30,29,1,2,0,2
202501,23137,28,25,3,100,0,100
202409,12632,42,34,8,100,0,100
202409,11433,10,7,3,4,0,4
202501,21246,40,40,0,40,34,6
202409,10526,30,28,2,4,0,4
202501,21785,24,19,5,15,0,15
202501,21564,22,22,0,0,0,0
202501,22275,5,0,5,5,0,5
202409,13025,70,69,1,10,0,10
202501,21900,40,39,1,40,0,40
202501,22985,38,38,0,50,44,6
202409,12757,68,49,19,0,0,0
202501,21543,22,22,0,0,0,0
202409,12339,16,16,0,100,0,100
202501,21230,22,20,2,40,0,40
202409,13135,38,36,2,50,0,50
202501,21643,50,25,25,100,0,100
202501,23957,24,24,0,15,2,13
202409,10086,25,22,3,20,0,20
202409,11611,20,19,1,100,0,100
202409,14134,3,1,2,3,0,3
202501,20879,24,14,10,3,0,3
202501,21233,59,59,0,35,3,32
202501,21149,32,31,1,30,0,30
202409,12597,35,13,22,100,0,100
202409,11321,100,68,32,10,0,10
202409,10403,12,12,0,4,0,4
202501,23058,26,22,4,100,0,100
202409,12575,29,10,19,20,0,20
202501,20638,55,17,38,10,0,10
202409,12248,24,21,3,5,0,5
202409,11874,50,49,1,100,0,100
202409,13644,30,20,10,100,0,100
202409,10528,30,12,18,4,0,4
202501,23781,10,4,6,100,0,100
202409,11852,30,7,23,20,0,20
202501,20602,64,64,0,10,0,10
202501,21649,20,10,10,100,0,100
202409,11517,16,18,-2,5,0,5
202501,20036,30,20,10,20,0,20
202501,21542,22,22,0,0,0,0
202501,20426,358,333,25,100,0,100
202501,23554,9,9,0,100,0,100
202409,12933,100,98,2,100,0,100
202409,10435,12,0,12,3,0,3
202501,20143,18,19,-1,100,3,97
202409,12894,25,26,-1,0,0,0
202501,22166,5,0,5,5,0,5
202501,23157,50,50,0,100,11,89
202501,20430,92,92,0,0,0,0
202409,13149,18,3,15,50,0,50
202501,20043,30,30,0,15,5,10
202501,21258,50,49,1,40,6,34
202409,12634,40,20,20,100,0,100
202409,11518,16,16,0,5,0,5
202501,21859,45,45,0,100,15,85
202409,13118,38,31,7,50,0,50
202501,22228,34,34,0,10,3,7
202501,22298,3,0,3,3,0,3
202409,12552,21,18,3,0,0,0
202501,23169,12,12,0,100,1,99
202409,10339,22,22,0,2,0,2
202501,23805,25,19,6,0,0,0
202501,22714,25,25,0,0,0,0
202409,10589,20,20,0,2,0,2
202501,22026,110,70,40,100,0,100
202409,10821,50,49,1,10,0,10
202501,22181,5,0,5,5,0,5
202409,11843,317,226,91,20,0,20
202501,21645,31,10,21,100,0,100
202501,21351,18,18,0,5,5,0
202501,21373,16,16,0,5,5,0
202409,13006,40,33,7,0,0,0
202501,20670,30,26,4,0,0,0
202501,20023,33,33,0,50,0,50
202409,11923,35,14,21,35,0,35
202409,11742,25,14,11,0,0,0
202501,21923,40,10,30,20,0,20
202501,22178,5,0,5,5,0,5
202501,20335,65,65,0,100,22,78
202501,21476,60,60,0,100,52,48
202409,10785,55,55,0,0,0,0
202501,20190,15,15,0,100,0,100
202409,12069,55,53,2,12,0,12
202501,20654,90,90,0,25,1,24
202501,21297,19,19,0,4,1,3
202501,21598,88,88,0,100,6,94
202501,20610,64,68,-4,10,0,10
202409,10068,10,12,-2,0,0,0
202409,11082,60,55,5,100,0,100
202501,20648,30,28,2,0,0,0
202409,10234,32,32,0,100,0,100
202501,23507,6,1,5,100,0,100
202501,22832,25,25,0,25,5,20
202501,23476,15,7,8,100,0,100
202409,11078,31,18,13,0,0,0
202409,14053,3,3,0,0,0,0
202501,22474,50,36,14,100,0,100
202501,20499,20,1,19,0,0,0
202501,20319,20,20,0,2,2,0
202409,12363,5,1,4,5,0,5
202409,10241,32,32,0,100,0,100
202409,11667,22,22,0,0,0,0
202501,22054,25,23,2,30,0,30
202409,13753,60,65,-5,100,0,100
202409,10401,12,12,0,4,0,4
202409,10761,21,20,1,0,0,0
202501,23946,15,0,15,0,0,0
202409,10320,22,22,0,4,0,4
202501,22164,5,1,4,5,0,5
202501,20386,40,20,20,100,0,100
202501,20383,30,9,21,0,0,0
202409,13680,15,14,1,100,0,100
202501,23053,180,127,53,75,0,75
202501,20288,24,23,1,4,4,0
202409,12839,20,20,0,2,0,2
202501,22033,44,22,22,0,0,0
202409,13745,50,0,50,0,0,0
202501,23173,50,50,0,100,0,100
202501,21281,23,23,0,4,1,3
202409,10736,31,29,2,0,0,0
202409,13147,18,17,1,50,0,50
202409,12065,215,192,23,90,0,90
202409,14084,32,29,3,3,0,3
202409,10949,32,32,0,3,0,3
202501,20643,30,30,0,0,0,0
202501,22242,3,1,2,2,0,2
202501,20425,32,12,20,0,0,0
202409,12294,5,2,3,5,0,5
202501,21118,35,35,0,100,12,88
202409,11649,5,3,2,0,0,0
202501,23188,20,20,0,100,7,93
202501,21755,40,26,14,100,0,100
202409,14235,25,23,2,0,0,0
202409,12793,20,20,0,2,0,2
202409,12824,15,8,7,2,0,2
202409,11351,60,16,44,60,0,60
202409,12017,200,146,54,100,0,100
202409,11721,50,39,11,30,0,30
202409,13232,20,17,3,10,0,10
202409,10664,45,33,12,100,0,100
202501,20451,30,8,22,4,0,4
202501,21171,30,22,8,2,0,2
202501,22643,20,20,0,2,0,2
202501,22221,5,0,5,5,0,5
202501,22440,35,10,25,100,0,100
202409,13910,10,3,7,100,0,100
202409,11612,20,16,4,100,0,100
202501,21161,30,29,1,2,0,2
202501,20885,16,7,9,3,0,3
202501,22466,60,60,0,100,6,94
202409,11115,30,28,2,0,0,0
202501,23846,30,23,7,0,0,0
202409,12031,40,27,13,75,0,75
202501,20745,60,42,18,0,0,0
202501,21743,50,50,0,100,1,99
202501,22870,15,8,7,100,0,100
202501,21234,60,60,0,60,0,60
202409,10098,22,7,15,10,0,10
202409,12746,53,52,1,100,0,100
202409,12887,25,25,0,0,0,0
202501,20926,30,30,0,3,2,1
202409,12278,5,0,5,5,0,5
202409,12299,15,12,3,100,0,100
202501,21426,8,0,8,0,0,0
202409,12364,5,0,5,5,0,5
202501,20967,35,34,1,0,0,0
202409,10062,50,40,10,20,0,20
202409,10184,18,15,3,0,0,0
202409,12292,5,2,3,5,0,5
202409,10760,21,20,1,0,0,0
202501,20134,24,24,0,100,5,95
202501,22772,25,25,0,100,72,28
202409,12051,40,41,-1,10,0,10
202409,14034,25,14,11,5,0,5
202501,21184,2,0,2,1,0,1
202501,20186,13,12,1,0,0,0
202501,22578,45,45,0,100,10,90
202501,21803,30,8,22,30,0,30
202409,12441,5,3,2,5,0,5
202501,22423,35,14,21,100,0,100
202409,13696,150,131,19,100,0,100
202501,20254,80,47,33,100,0,100
202409,13305,15,15,0,100,0,100
202409,13951,30,24,6,0,0,0
202409,10673,31,31,0,0,0,0
202501,23144,7,7,0,100,1,99
202501,22268,5,0,5,5,0,5
202501,23769,10,0,10,100,0,100
202409,12908,35,35,0,0,0,0
202409,11615,24,12,12,20,0,20
202409,12545,45,45,0,0,0,0
202409,12886,25,25,0,0,0,0
202501,23777,10,8,2,100,0,100
202409,10168,160,120,40,20,0,20
202409,11685,22,22,0,0,0,0
202501,23629,20,10,10,0,0,0
202501,22101,22,7,15,5,0,5
202409,12388,3,0,3,3,0,3
202501,22395,80,1,79,0,0,0
202409,13947,25,15,10,0,0,0
202501,22936,60,60,0,100,3,97
202501,21922,40,10,30,20,0,20
202409,14079,200,79,121,0,0,0
202409,10402,12,12,0,4,0,4
202409,13850,50,50,0,100,0,100
202409,11475,18,18,0,5,0,5
202409,11648,5,2,3,0,0,0
202501,21509,20,1,19,100,0,100
202501,20385,40,0,40,100,0,100
202409,11934,30,9,21,30,0,30
202409,13166,38,33,5,50,0,50
202409,11550,10,0,10,100,0,100
202501,23037,30,30,0,20,0,20
202501,20545,40,15,25,50,0,50
202409,13649,25,7,18,100,0,100
202501,21279,23,23,0,4,1,3
202501,21758,65,64,1,100,0,100
202409,12177,160,115,45,50,0,50
202501,21061,33,33,0,0,0,0
202501,20108,25,13,12,100,0,100
202501,22594,20,12,8,100,0,100
202409,13597,12,9,3,100,0,100
202409,10692,33,28,5,0,0,0
202501,20072,250,144,106,100,0,100
202409,12404,25,5,20,100,0,100
202501,22263,5,0,5,5,0,5
202409,13290,50,49,1,100,0,100
202409,10955,18,18,0,3,0,3
202501,22889,13,13,0,100,0,100
202501,21460,150,107,43,100,0,100
202501,22248,25,8,17,100,0,100
202409,11338,33,31,2,100,0,100
202501,20167,18,18,0,0,0,0
202409,10980,28,19,9,3,0,3
202501,22818,45,12,33,10,0,10
202409,13946,3,2,1,0,0,0
202409,11480,120,119,1,100,0,100
202501,21663,60,59,1,100,0,100
202409,13616,15,12,3,100,0,100
202501,21617,25,25,0,20,0,20
202409,10901,45,29,16,100,0,100
202501,21215,33,33,0,100,9,91
202409,12274,5,3,2,5,0,5
202501,22829,25,23,2,0,0,0
202501,23847,30,22,8,0,0,0
202501,23123,15,15,0,100,0,100
202409,12591,35,13,22,100,0,100
202409,13587,18,20,-2,100,0,100
202409,11183,8,1,7,0,0,0
202409,13944,25,15,10,0,0,0
202409,12253,24,11,13,5,0,5
202501,21462,50,22,28,100,0,100
202501,22203,100,41,59,100,0,100
202501,23538,25,25,0,0,0,0
202501,21466,19,11,8,10,0,10
202501,21387,60,30,30,100,0,100
202409,11632,50,7,43,10,0,10
202409,13204,35,24,11,100,0,100
202501,22554,24,24,0,0,0,0
202501,23598,30,1,29,0,0,0
202409,14108,20,10,10,0,0,0
202409,11591,30,20,10,100,0,100
202501,21905,40,40,0,40,0,40
202501,20244,30,27,3,100,0,100
202501,22425,10,2,8,15,0,15
202501,20001,30,9,21,20,0,20
202501,20099,60,60,0,100,6,94
202409,12944,20,20,0,100,0,100
202501,21294,19,21,-2,4,1,3
202409,10683,31,24,7,0,0,0
202409,12979,10,6,4,100,0,100
202409,11323,120,64,56,10,0,10
202501,22482,12,11,1,100,0,100
202501,20753,10,10,0,25,7,18
202501,23496,20,9,11,5,0,5
202409,11847,35,31,4,10,0,10
202409,12033,40,33,7,7,0,7
202501,22297,3,2,1,3,0,3
202501,21944,60,30,30,35,0,35
202501,20626,240,227,13,40,0,40
202501,21898,40,40,0,40,37,3
202409,13303,38,33,5,100,0,100
202501,23033,35,12,23,100,0,100
202501,20291,24,24,0,4,4,0
202409,13921,35,17,18,20,0,20
202501,22236,3,0,3,3,0,3
202501,20702,20,20,0,0,0,0
202409,11163,33,33,0,0,0,0
202409,14182,22,22,0,50,0,50
202501,22036,80,22,58,0,0,0
202409,10145,24,25,-1,100,0,100
202409,11885,43,24,19,100,0,100
202501,22661,20,6,14,2,0,2
202501,21931,200,200,0,100,28,72
202501,21516,35,31,4,20,0,20
202501,20601,64,63,1,10,0,10
202501,20558,45,28,17,100,0,100
202501,21181,2,2,0,1,0,1
202409,12171,36,33,3,5,0,5
202501,23990,18,0,18,0,0,0
202501,23567,50,42,8,100,0,100
202409,10705,33,31,2,0,0,0
202409,12677,24,21,3,0,0,0
202501,21156,30,16,14,30,0,30
202409,13977,10,0,10,100,0,100
202409,10138,22,22,0,100,0,100
202501,21749,40,40,0,100,0,100
202409,11560,24,22,2,5,0,5
202409,12391,3,0,3,3,0,3
202501,22886,25,24,1,100,0,100
202501,22662,110,90,20,100,0,100
202501,21858,10,1,9,100,0,100
202501,23595,30,0,30,0,0,0
202409,10767,21,20,1,0,0,0
202409,10638,64,65,-1,10,0,10
202409,11738,30,27,3,100,0,100
202409,11289,28,27,1,2,0,2
202501,20687,20,5,15,10,0,10
202409,10103,40,37,3,100,0,100
202409,11930,30,27,3,30,0,30
202501,22199,6,0,6,100,0,100
202501,20112,20,20,0,100,3,97
202501,22966,22,21,1,50,0,50
202409,10373,24,22,2,100,0,100
202409,11613,20,18,2,100,0,100
202409,11983,40,31,9,100,0,100
202501,22510,24,16,8,0,0,0
202501,22027,150,59,91,20,0,20
202501,23775,10,3,7,100,0,100
202501,22302,25,11,14,25,0,25
202409,13061,25,25,0,100,0,100
202501,20381,26,26,0,100,6,94
202409,11707,100,97,3,40,0,40
202501,21029,30,5,25,100,0,100
202409,11561,24,23,1,5,0,5
202501,22167,5,1,4,5,0,5
202409,10211,32,32,0,100,0,100
202501,20707,20,20,0,0,0,0
202409,14162,32,30,2,100,0,100
202409,11353,23,24,-1,23,0,23
202501,22731,100,100,0,100,17,83
202501,21024,80,24,56,100,0,100
202501,20606,64,67,-3,10,0,10
202409,12341,25,24,1,25,0,25
202501,21350,144,141,3,100,48,52
202501,20384,30,9,21,100,0,100
202409,10907,45,41,4,100,0,100
202409,10974,164,152,12,50,0,50
202409,13119,38,34,4,50,0,50
202409,12843,52,46,6,100,0,100
202409,12351,6,1,5,100,0,100
202501,21537,22,21,1,0,0,0
202409,11795,45,42,3,0,0,0
202501,20429,92,92,0,0,0,0
202501,20339,80,80,0,100,5,95
202501,21730,90,90,0,100,0,100
202409,10294,24,23,1,4,0,4
202501,21910,40,25,15,40,0,40
202501,21751,50,28,22,100,0,100
202501,22142,5,0,5,5,0,5
202409,12243,35,27,8,50,0,50
202409,10961,20,10,10,50,0,50
202409,10639,64,66,-2,10,0,10
202409,10272,300,283,17,100,0,100
202501,22111,86,46,40,100,0,100
202409,10411,58,60,-2,100,0,100
202409,13735,12,12,0,100,0,100
202501,23738,20,20,0,100,4,96
202501,20442,120,115,5,100,0,100
202409,10824,15,13,2,0,0,0
202501,20624,45,43,2,100,9,91
202409,10028,33,32,1,50,0,50
202409,12151,24,24,0,10,0,10
202501,21987,32,29,3,8,5,3
202409,10281,24,23,1,4,0,4
202409,14175,45,38,7,100,0,100
202501,21110,75,70,5,0,0,0
202409,11700,50,43,7,50,0,50
202409,13725,54,54,0,100,0,100
202409,14005,20,16,4,100,0,100
202501,21102,20,9,11,25,0,25
202501,20229,43,20,23,100,0,100
202501,21250,47,47,0,40,10,30
202409,10681,31,29,2,0,0,0
202501,21186,2,2,0,1,0,1
202409,12156,24,23,1,10,0,10
202409,10470,92,85,7,0,0,0
202409,13868,50,14,36,0,0,0
202409,11099,30,16,14,0,0,0
202409,12070,55,43,12,12,0,12
202409,10745,31,28,3,0,0,0
202501,20133,24,24,0,100,9,91
202501,21844,5,0,5,0,0,0
202409,11371,56,49,7,40,0,40
202501,20902,16,16,0,3,3,0
202501,22560,24,24,0,0,0,0
202409,12080,80,65,15,40,0,40
202409,13076,25,24,1,100,0,100
202501,22163,5,0,5,5,0,5
202409,13941,25,10,15,0,0,0
202409,10787,55,34,21,0,0,0
202409,10788,85,58,27,25,0,25
202409,10486,30,30,0,4,0,4
202409,12889,25,25,0,0,0,0
202409,11625,43,28,15,5,0,5
202501,21441,30,0,30,100,0,100
202501,21066,35,35,0,50,5,45
202409,14269,1,1,0,0,0,0
202501,21941,180,170,10,90,0,90
202409,14140,50,47,3,20,0,20
202501,23996,18,1,17,0,0,0
202409,13296,25,31,-6,0,0,0
202409,11495,15,15,0,0,0,0
202501,22119,50,30,20,100,0,100
202501,20495,40,12,28,120,0,120
202409,10759,21,21,0,0,0,0
202501,23518,14,8,6,100,0,100
202501,20401,25,11,14,0,0,0
202501,20107,60,45,15,100,0,100
202409,12309,60,33,27,100,0,100
202501,22121,60,32,28,100,0,100
202409,12431,5,1,4,5,0,5
202501,22828,25,25,0,0,0,0
202501,21502,20,20,0,100,1,99
202409,11871,22,20,2,100,0,100
202501,20730,80,89,-9,40,21,19
202409,10372,22,20,2,4,0,4
202409,13733,18,18,0,100,0,100
202501,20989,40,32,8,100,0,100
202501,21527,5,1,4,0,0,0
202501,23822,25,14,11,0,0,0
202501,21265,15,8,7,5,0,5
202501,23077,36,36,0,100,5,95
202409,11003,12,11,1,3,0,3
202501,21588,23,23,0,0,0,0
202501,22989,38,38,0,50,21,29
202501,21487,22,15,7,20,0,20
202501,23023,35,32,3,100,0,100
202409,12117,45,34,11,15,0,15
202409,12798,140,119,21,100,0,100
202409,11384,40,38,2,100,0,100
202409,13919,35,28,7,20,0,20
202501,22934,60,60,0,100,40,60
202501,21718,60,60,0,20,0,20
202409,12161,180,124,56,50,0,50
202409,11510,36,34,2,30,0,30
202409,12717,24,22,2,0,0,0
202409,12589,10,0,10,100,0,100
202409,12551,21,17,4,0,0,0
202409,14065,40,15,25,100,0,100
202409,12172,38,37,1,5,0,5
202409,13973,10,1,9,100,0,100
202501,23108,14,11,3,100,0,100
202409,13313,13,13,0,100,0,100
202501,22580,9,9,0,0,0,0
202501,21288,175,107,68,100,0,100
202501,21170,30,29,1,2,0,2
202409,10230,32,32,0,100,0,100
202409,11925,20,14,6,20,0,20
202501,21594,22,20,2,0,0,0
202501,22202,20,18,2,100,0,100
202409,11306,4,4,0,3,0,3
202501,21990,130,115,15,0,0,0
202501,20478,10,8,2,4,0,4
202501,20373,110,106,4,100,13,87
202409,11472,18,18,0,5,0,5
202501,22438,20,0,20,15,0,15
202409,11553,250,224,26,100,0,100
202409,11698,22,22,0,0,0,0
202501,23475,15,12,3,100,0,100
202501,20352,20,20,0,4,4,0
202501,20914,12,9,3,50,0,50
202501,21096,150,73,77,100,0,100
202409,10237,32,32,0,100,0,100
202409,11552,10,2,8,100,0,100
202501,20743,20,12,8,0,0,0
202409,10174,18,11,7,0,0,0
202501,23440,24,24,0,20,15,5
202409,11818,53,49,4,5,0,5
202409,10968,1,0,1,2,0,2
202501,20979,30,30,0,0,0,0
202501,21866,10,3,7,100,0,100
202501,20987,55,55,0,100,0,100
202409,12421,5,0,5,5,0,5
202409,13098,70,71,-1,100,0,100
202409,12821,80,70,10,100,0,100
202409,10957,32,32,0,3,0,3
202409,10653,50,31,19,100,0,100
202409,14083,200,184,16,0,0,0
202501,22752,100,100,0,100,95,5
202409,11979,10,4,6,20,0,20
202501,21007,90,27,63,100,0,100
202501,23082,16,12,4,100,0,100
202409,11438,54,31,23,4,0,4
202501,20817,30,29,1,100,0,100
202409,11425,16,9,7,4,0,4
202409,11590,30,26,4,100,0,100
202501,23138,15,15,0,100,4,96
202501,20222,32,32,0,100,11,89
202409,10118,25,21,4,100,0,100
202409,12082,80,76,4,40,0,40
202409,12443,5,0,5,5,0,5
202409,12389,3,0,3,3,0,3
202501,20966,35,8,27,0,0,0
202501,20242,100,0,100,100,0,100
202501,23981,38,38,0,50,3,47
202501,21374,16,16,0,5,0,5
202501,20822,60,35,25,100,0,100
202409,14141,24,25,-1,15,0,15
202501,22504,24,24,0,0,0,0
202409,10166,34,34,0,100,0,100
202501,21468,19,8,11,10,0,10
202409,10669,148,140,8,25,0,25
202409,10715,33,33,0,0,0,0
202409,11623,50,26,24,10,0,10
202409,10239,32,32,0,100,0,100
202409,12063,40,30,10,10,0,10
202501,20895,20,20,0,3,0,3
202409,10280,24,24,0,4,0,4
202409,12805,20,13,7,2,0,2
202501,20048,50,50,0,20,6,14
202409,13049,5,4,1,10,0,10
202501,22975,18,0,18,50,0,50
202409,13023,12,9,3,0,0,0
202501,23914,35,0,35,0,0,0
202409,13262,14,15,-1,100,0,100
202501,20557,70,19,51,100,0,100
202409,12030,50,33,17,20,0,20
202409,12328,5,0,5,5,0,5
202501,20202,32,32,0,100,24,76
202501,20975,30,30,0,0,0,0
202501,21725,20,13,7,0,0,0
202409,14002,25,19,6,0,0,0
202409,10210,32,30,2,100,0,100
202409,10699,33,30,3,0,0,0
202409,10946,32,30,2,3,0,3
202409,10888,45,39,6,100,0,100
202501,21558,88,86,2,88,0,88
202501,23039,30,13,17,15,0,15
202409,12635,25,10,15,100,0,100
202501,21805,20,8,12,20,0,20
202409,12724,24,21,3,0,0,0
202501,22472,60,45,15,100,0,100
202409,11238,42,40,2,0,0,0
202501,23055,50,50,0,22,0,22
202409,13205,35,32,3,100,0,100
202409,11406,24,21,3,4,0,4
202501,22090,50,20,30,100,0,100
202501,20964,35,35,0,0,0,0
202409,12190,151,110,41,30,0,30
202409,11453,15,0,15,100,0,100
202501,22679,35,35,0,100,8,92
202409,12702,24,23,1,0,0,0
202409,12175,80,71,9,30,0,30
202501,20667,30,30,0,0,0,0
202501,21289,19,19,0,4,1,3
202409,10512,30,29,1,4,0,4
202409,13121,18,13,5,50,0,50
202501,22434,60,50,10,100,0,100
202409,13627,5,2,3,5,0,5
202409,10030,32,32,0,50,0,50
202501,21062,33,31,2,0,0,0
202409,10189,18,10,8,0,0,0
202409,10029,45,43,2,50,0,50
202501,20560,40,19,21,100,0,100
202501,23136,28,28,0,100,1,99
202409,13167,11,7,4,30,0,30
202501,23772,10,2,8,100,0,100
202501,21849,5,2,3,20,0,20
202409,12188,30,30,0,16,0,16
202409,13795,30,23,7,0,0,0
202409,11815,60,42,18,5,0,5
202501,20135,24,24,0,100,9,91
202409,11467,18,20,-2,5,0,5
202501,23667,20,0,20,0,0,0
202409,10594,38,38,0,15,0,15
202409,11736,22,22,0,100,0,100
202409,10630,64,65,-1,10,0,10
202409,13201,35,28,7,100,0,100
202501,23100,12,12,0,100,2,98
202409,10809,26,24,2,25,0,25
202501,22912,25,25,0,100,0,100
202409,11061,35,35,0,0,0,0
202501,21272,50,49,1,50,6,44
202501,21798,31,31,0,30,0,30
202501,22755,100,100,0,100,45,55
202501,21228,22,22,0,40,0,40
202409,11647,5,3,2,0,0,0
202501,20916,14,11,3,10,0,10
202501,23664,20,0,20,0,0,0
202501,20101,20,15,5,10,0,10
202409,10810,23,21,2,0,0,0
202501,22722,200,200,0,100,100,0
202409,13767,60,63,-3,100,0,100
202409,13259,25,8,17,100,0,100
202501,21840,20,0,20,100,0,100
202409,12543,46,46,0,0,0,0
202409,10291,24,24,0,4,0,4
202409,11507,35,34,1,0,0,0
202409,12817,20,17,3,2,0,2
202409,10908,60,30,30,100,0,100
202501,21676,75,69,6,100,0,100
202501,20598,100,43,57,0,0,0
202409,10963,46,44,2,50,0,50
202409,10612,50,50,0,50,0,50
202501,22626,20,20,0,2,0,2
202409,13671,105,98,7,100,0,100
202409,12913,35,35,0,0,0,0
202409,12630,60,50,10,100,0,100
202501,22684,20,20,0,100,13,87
202501,21357,18,17,1,5,4,1
202409,10663,45,44,1,100,0,100
202501,20033,150,149,1,30,2,28
202409,12254,24,14,10,5,0,5
202409,12327,5,0,5,5,0,5
202409,12335,3,0,3,3,0,3
202409,11209,20,5,15,0,0,0
202501,20057,10,9,1,0,0,0
202501,22820,30,30,0,0,0,0
202501,23823,25,7,18,0,0,0
202409,10803,55,48,7,25,0,25
202501,23189,50,0,50,100,0,100
202409,10187,18,11,7,0,0,0
202409,12283,5,2,3,5,0,5
202501,20095,50,49,1,100,1,99
202409,12596,35,13,22,30,0,30
202501,22939,60,60,0,100,8,92
202409,10572,80,79,1,100,0,100
202409,10477,16,16,0,0,0,0
202409,11302,3,3,0,3,0,3
202409,12836,20,20,0,2,0,2
202501,21263,22,22,0,22,7,15
202409,10734,31,29,2,0,0,0
202501,20875,24,10,14,3,0,3
202501,23533,105,95,10,0,0,0
202409,13766,65,64,1,100,0,100
202409,11123,60,12,48,100,0,100
202409,11056,35,35,0,0,0,0
202409,13945,25,15,10,0,0,0
202501,22726,250,249,1,100,49,51
202501,23551,35,21,14,100,0,100
202409,12818,20,20,0,2,0,2
202409,10513,30,13,17,4,0,4
202409,12246,299,155,144,100,0,100
202501,23152,40,40,0,100,12,88
202501,20307,20,20,0,2,2,0
202501,21185,2,1,1,1,0,1
202501,21341,15,7,8,100,0,100
202501,22458,150,150,0,100,18,82
202409,13920,35,21,14,20,0,20
202409,13948,25,18,7,0,0,0
202501,23548,75,57,18,0,0,0
202409,12160,84,82,2,30,0,30
202409,11447,45,31,14,100,0,100
202501,21855,60,47,13,100,0,100
202501,23865,35,12,23,0,0,0
202409,12899,250,250,0,100,0,100
202501,20988,90,73,17,100,0,100
202501,22477,35,29,6,100,0,100
202501,21147,32,32,0,30,4,26
202409,13714,45,39,6,100,0,100
202409,11269,32,32,0,30,0,30
202501,20171,144,123,21,10,0,10
202501,21182,2,1,1,1,0,1
202501,21612,22,22,0,0,0,0
202409,10033,33,29,4,50,0,50
202409,10527,30,30,0,4,0,4
202409,11057,35,35,0,0,0,0
202409,10214,32,32,0,100,0,100
202409,10053,25,24,1,100,0,100
202409,12107,60,47,13,30,0,30
202409,10252,100,2,98,100,0,100
202501,22449,50,24,26,20,0,20
202409,13647,14,1,13,100,0,100
202501,22759,100,100,0,100,93,7
202409,11757,33,11,22,100,0,100
202501,21536,22,22,0,0,0,0
202409,10753,33,34,-1,0,0,0
202501,21442,30,0,30,100,0,100
202501,21896,40,39,1,40,10,30
202409,11581,30,30,0,100,0,100
202501,21939,60,59,1,20,0,20
202501,20737,120,120,0,40,0,40
202409,11854,150,151,-1,100,0,100
202501,22251,50,7,43,100,0,100
202501,23565,25,19,6,100,0,100
202501,21203,40,40,0,5,3,2
202409,11699,22,22,0,0,0,0
202501,20489,20,4,16,10,0,10
202501,23750,30,10,20,20,0,20
202409,11720,40,37,3,100,0,100
202501,23760,45,35,10,100,0,100
202501,20500,20,12,8,0,0,0
202409,13138,38,31,7,50,0,50
202501,23472,280,255,25,0,0,0
202501,21607,22,22,0,0,0,0
202409,12629,40,24,16,100,0,100
202409,12666,24,24,0,0,0,0
202501,20469,16,15,1,4,4,0
202501,20182,13,13,0,0,0,0
202501,20496,40,33,7,20,0,20
202409,10591,20,18,2,2,0,2
202501,23097,12,7,5,100,0,100
202409,12163,24,24,0,10,0,10
202501,21174,28,28,0,2,1,1
202501,22866,30,16,14,100,0,100
202501,22713,25,25,0,0,0,0
202501,22768,100,100,0,100,95,5
202409,10993,16,15,1,3,0,3
202409,12028,50,23,27,20,0,20
202501,21199,40,40,0,5,0,5
202501,22543,24,24,0,0,0,0
202501,20440,46,46,0,0,0,0
202409,10353,22,21,1,2,0,2
202409,10276,275,92,183,100,0,100
202409,13670,105,80,25,100,0,100
202501,23665,20,0,20,0,0,0
202501,21935,50,46,4,30,0,30
202409,11502,16,16,0,5,0,5
202409,10273,300,281,19,100,0,100
202501,22856,40,14,26,10,0,10
202409,13790,14,13,1,0,0,0
202409,12804,20,20,0,2,0,2
202501,21559,22,21,1,0,0,0
202501,23156,50,50,0,100,6,94
202501,23449,18,15,3,0,0,0
202409,13225,200,81,119,100,0,100
202501,22630,20,9,11,2,0,2
202409,11226,25,23,2,25,0,25
202409,11991,55,30,25,100,0,100
202501,22807,20,20,0,25,4,21
202501,23817,25,16,9,0,0,0
202501,22508,24,24,0,0,0,0
202409,12738,18,19,-1,0,0,0
202409,11558,24,20,4,5,0,5
202409,11990,45,29,16,100,0,100
202409,10249,26,26,0,10,0,10
202409,13757,60,62,-2,100,0,100
202501,23859,15,11,4,0,0,0
202409,10646,64,65,-1,10,0,10
202501,21688,30,28,2,10,0,10
202501,21392,60,60,0,50,13,37
202501,20022,45,45,0,100,9,91
202501,20353,155,155,0,100,46,54
202501,21190,2,0,2,1,0,1
202501,22301,20,4,16,10,0,10
202501,21447,250,216,34,100,0,100
202409,10565,42,41,1,5,0,5
202409,12847,52,46,6,100,0,100
202501,21799,30,9,21,0,0,0
202501,21850,5,5,0,20,0,20
202501,21220,33,32,1,100,13,87
202501,21762,12,12,0,100,2,98
202501,21740,60,30,30,100,0,100
202501,21004,75,43,32,100,0,100
202501,22702,250,212,38,100,0,100
202409,10324,22,21,1,4,0,4
202501,22586,9,6,3,0,0,0
202409,13892,40,27,13,25,0,25
202501,22200,5,1,4,5,0,5
202501,20655,25,25,0,10,0,10
202501,20476,100,100,0,20,3,17
202409,10801,73,58,15,25,0,25
202501,21020,60,16,44,100,0,100
202501,22154,25,2,23,100,0,100
202501,20076,25,16,9,20,0,20
202501,21358,18,18,0,5,4,1
202501,22663,20,15,5,2,0,2
202501,22122,30,26,4,100,0,100
202501,22914,25,24,1,100,0,100
202409,10483,140,132,8,100,0,100
202501,23951,1,1,0,0,0,0
202409,13090,80,77,3,100,0,100
202409,11511,18,17,1,5,0,5
202409,13827,10,1,9,0,0,0
202409,12749,10,10,0,0,0,0
202501,21514,35,33,2,20,13,7
202501,23727,10,0,10,100,0,100
202501,21957,70,66,4,35,0,35
202501,20604,65,35,30,100,0,100
202409,12212,25,0,25,5,0,5
202501,22187,3,3,0,0,0,0
202501,22136,5,2,3,5,0,5
202409,11851,25,18,7,10,0,10
202409,13195,90,46,44,10,0,10
202409,10634,64,63,1,10,0,10
202409,10610,120,119,1,100,0,100
202409,13955,30,25,5,0,0,0
202409,10977,28,28,0,3,0,3
202501,20020,33,33,0,50,2,48
202501,20607,64,62,2,10,0,10
202501,20330,20,20,0,4,4,0
202501,22711,25,25,0,0,0,0
202409,12699,24,23,1,0,0,0
202409,13584,18,13,5,100,0,100
202409,11866,70,33,37,100,0,100
202501,22633,20,20,0,2,0,2
202501,20308,20,20,0,2,2,0
202501,20437,299,298,1,50,39,11
202409,13073,25,24,1,100,0,100
202501,22933,60,60,0,100,1,99
202409,10710,6,6,0,10,0,10
202409,12344,25,9,16,100,0,100
202501,21820,24,5,19,15,0,15
202501,21034,30,7,23,100,0,100
202501,23043,50,50,0,20,4,16
202409,12857,20,19,1,100,0,100
202409,11068,35,30,5,0,0,0
202501,21986,32,28,4,8,2,6
202501,21654,50,37,13,100,0,100
202409,11419,75,33,42,100,0,100
202409,12741,9,8,1,0,0,0
202409,10283,24,24,0,4,0,4
202409,11176,45,37,8,100,0,100
202409,12708,24,22,2,0,0,0
202501,20098,45,44,1,100,0,100
202409,13126,22,19,3,30,0,30
202409,12439,5,0,5,5,0,5
202409,12711,24,22,2,0,0,0
202501,23764,10,2,8,100,0,100
202501,22553,24,24,0,0,0,0
202501,21218,33,33,0,100,10,90
202501,22858,20,20,0,0,0,0
202501,21005,70,19,51,100,0,100
202501,22808,15,8,7,50,0,50
202409,13965,10,7,3,100,0,100
202501,23943,18,2,16,50,0,50
202501,20990,40,10,30,100,0,100
202501,20448,110,91,19,100,0,100
202501,20163,18,17,1,0,0,0
202409,10807,55,46,9,0,0,0
202501,21523,28,14,14,10,0,10
202409,13301,15,13,2,100,0,100
202409,10650,55,52,3,50,0,50
202409,10395,55,55,0,100,0,100
202501,22778,25,25,0,30,17,13
202409,10960,132,110,22,50,0,50
202501,20217,32,32,0,100,17,83
202501,21414,15,15,0,5,1,4
202409,13712,50,31,19,100,0,100
202501,20051,50,50,0,100,3,97
202501,23746,30,11,19,20,0,20
202501,22653,20,6,14,2,0,2
202501,23050,50,48,2,25,17,8
202501,21032,40,34,6,100,0,100
202409,14247,1,1,0,0,0,0
202501,22868,30,8,22,100,0,100
202409,10748,31,34,-3,0,0,0
202409,10903,45,31,14,100,0,100
202409,11348,60,33,27,60,0,60
202409,10399,75,53,22,100,0,100
202501,22986,38,38,0,50,11,39
202501,20965,35,33,2,0,0,0
202409,14101,24,19,5,0,0,0
202409,14206,5,1,4,30,0,30
202501,20862,10,10,0,3,0,3
202501,23821,25,13,12,0,0,0
202409,12930,100,98,2,100,0,100
202501,23166,25,25,0,100,7,93
202501,21065,35,26,9,50,0,50
202409,14027,60,58,2,100,0,100
202409,13773,35,32,3,100,0,100
202409,12055,50,45,5,10,0,10
202501,20562,45,36,9,100,0,100
202501,23045,50,49,1,20,0,20
202501,22740,35,19,16,0,0,0
202409,10643,64,66,-2,10,0,10
202501,20726,65,22,43,0,0,0
202409,11120,40,11,29,100,0,100
202501,21202,40,40,0,5,3,2
202409,10257,100,5,95,100,0,100
202409,12269,71,67,4,100,0,100
202501,20901,16,16,0,3,3,0
202501,23021,35,34,1,100,13,87
202409,10474,92,88,4,0,0,0
202409,12355,9,2,7,5,0,5
202501,22634,20,20,0,2,0,2
202501,23956,30,13,17,100,0,100
202501,21318,16,16,0,4,4,0
202501,22265,5,1,4,5,0,5
202409,14106,20,10,10,0,0,0
202409,11158,35,33,2,50,0,50
202409,10841,5,1,4,10,0,10
202409,10388,20,20,0,4,0,4
202409,12380,5,0,5,5,0,5
202409,12061,40,22,18,10,0,10
202501,21794,30,0,30,50,0,50
202409,11576,30,30,0,25,0,25
202501,21464,19,15,4,10,0,10
202409,13716,45,38,7,100,0,100
202409,11734,25,19,6,25,0,25
202501,20203,32,31,1,100,14,86
202409,11407,24,22,2,4,0,4
202501,20647,175,87,88,17,0,17
202501,22817,130,106,24,13,0,13
202501,20179,18,9,9,0,0,0
202409,10284,24,24,0,4,0,4
202501,21197,40,40,0,5,2,3
202409,10899,45,24,21,100,0,100
202409,10765,21,21,0,0,0,0
202501,23168,20,20,0,100,3,97
202409,12844,50,39,11,100,0,100
202501,21526,30,7,23,10,0,10
202409,12417,5,0,5,5,0,5
202501,20908,24,18,6,50,0,50
202409,11214,30,7,23,0,0,0
202409,10143,24,24,0,100,0,100
202409,10666,30,7,23,100,0,100
202409,11383,40,41,-1,35,0,35
202409,11863,100,98,2,100,0,100
202409,13837,20,10,10,0,0,0
202409,12191,80,69,11,0,0,0
202409,11506,30,28,2,50,0,50
202501,23686,20,20,0,100,9,91
202501,22448,40,30,10,100,0,100
202501,22013,150,115,35,50,0,50
202501,21356,18,18,0,5,5,0
202501,21907,40,40,0,40,0,40
202409,13095,60,62,-2,100,0,100
202501,22176,5,0,5,5,0,5
202501,23087,5,3,2,0,0,0
202501,20265,24,24,0,4,4,0
202501,20816,30,30,0,100,0,100
202409,11758,25,9,16,100,0,100
202501,23919,35,0,35,0,0,0
202501,23870,10,4,6,0,0,0
202409,13904,10,4,6,100,0,100
202501,21398,18,11,7,5,0,5
202501,21273,50,49,1,35,0,35
202501,21399,18,10,8,5,0,5
202501,22665,20,18,2,2,0,2
202501,23751,30,13,17,20,0,20
202501,20342,20,20,0,4,4,0
202409,13161,38,26,12,50,0,50
202501,21793,20,8,12,20,0,20
202409,12316,5,1,4,5,0,5
202409,12761,24,15,9,100,0,100
202409,13928,40,39,1,10,0,10
202409,13723,50,49,1,100,0,100
202409,11311,3,3,0,3,0,3
202409,11114,75,52,23,100,0,100
202501,21208,32,32,0,30,9,21
202409,10896,20,13,7,100,0,100
202501,20337,18,18,0,4,4,0
202409,13309,25,25,0,100,0,100
202409,11521,40,40,0,30,0,30
202501,23094,16,11,5,100,0,100
202409,10966,1,0,1,2,0,2
202409,13967,10,4,6,100,0,100
202409,10998,16,14,2,3,0,3
202409,10181,144,99,45,10,0,10
202409,11324,33,31,2,100,0,100
202409,12242,80,58,22,100,0,100
202501,22100,22,22,0,5,0,5
202501,23054,100,77,23,45,0,45
202409,13032,28,27,1,0,0,0
202409,10245,60,48,12,100,0,100
202409,11669,22,20,2,0,0,0
202501,21245,99,99,0,90,6,84
202409,10054,100,99,1,20,0,20
202409,10982,110,78,32,50,0,50
202409,11917,26,21,5,10,0,10
202409,10791,17,12,5,0,0,0
202501,21367,200,199,1,100,35,65
202409,10813,23,22,1,0,0,0
202501,22235,3,0,3,3,0,3
202409,12114,65,45,20,32,0,32
202409,12792,20,16,4,2,0,2
202501,23674,25,9,16,0,0,0
202409,12450,3,2,1,3,0,3
202409,12976,50,21,29,30,0,30
202501,21217,32,32,0,100,10,90
202409,11225,25,24,1,25,0,25
202501,23599,30,0,30,0,0,0
202501,22865,50,50,0,100,2,98
202501,21661,53,53,0,100,16,84
202501,21028,60,45,15,100,0,100
202501,22683,20,21,-1,100,14,86
202501,22564,80,62,18,10,0,10
202501,24000,2,2,0,0,0,0
202501,20144,24,17,7,100,0,100
202409,13312,35,34,1,100,0,100
202501,21408,15,15,0,5,5,0
202409,10496,30,30,0,4,0,4
202501,23105,16,13,3,100,0,100
202501,22671,25,25,0,100,4,96
202409,11890,15,15,0,100,0,100
202409,12926,100,100,0,100,0,100
202409,10437,20,10,10,5,0,5
202409,11434,48,24,24,100,0,100
202409,12681,24,23,1,0,0,0
202409,13938,25,16,9,0,0,0
202501,22453,40,15,25,0,0,0
202409,12371,5,0,5,5,0,5
202501,21919,200,109,91,100,0,100
202409,11549,25,17,8,0,0,0
202409,12289,5,1,4,5,0,5
202501,22460,35,34,1,0,0,0
202501,20732,150,135,15,15,0,15
202501,22973,18,0,18,50,0,50
202501,20055,80,71,9,40,0,40
202409,10207,32,31,1,100,0,100
202501,22888,25,24,1,100,0,100
202409,11085,60,56,4,100,0,100
202409,10973,30,19,11,3,0,3
202501,20597,65,52,13,50,0,50
202409,11086,55,29,26,100,0,100
202501,23734,10,0,10,100,0,100
202501,20212,32,32,0,100,7,93
202501,22646,20,11,9,2,0,2
202501,23678,50,48,2,0,0,0
202501,22650,20,15,5,2,0,2
202409,10488,30,30,0,4,0,4
202409,10581,12,12,0,2,0,2
202409,11877,60,18,42,100,0,100
202409,13008,40,34,6,0,0,0
202409,11365,40,28,12,100,0,100
202409,13934,25,16,9,0,0,0
202409,11860,120,83,37,100,0,100
202409,11424,91,29,62,100,0,100
202409,11737,22,22,0,0,0,0
202501,21756,60,60,0,100,6,94
202501,23140,23,23,0,100,16,84
202501,20811,60,47,13,50,0,50
202501,21178,2,1,1,1,0,1
202501,21789,20,12,8,30,0,30
202409,10044,30,29,1,30,0,30
202409,12298,30,11,19,100,0,100
202501,23451,20,10,10,0,0,0
202409,10333,22,22,0,2,0,2
202409,11224,25,26,-1,25,0,25
202501,20529,80,62,18,100,0,100
202409,13137,38,35,3,50,0,50
202501,22185,3,0,3,3,0,3
202409,13929,40,36,4,10,0,10
202501,20018,30,30,0,50,4,46
202409,14054,2,1,1,0,0,0
202409,12736,18,17,1,0,0,0
202501,20592,80,60,20,5,0,5
202501,21677,10,9,1,100,0,100
202409,11684,22,17,5,0,0,0
202501,21330,23,16,7,4,0,4
202409,10994,16,12,4,3,0,3
202409,13591,20,21,-1,100,0,100
202501,20289,24,24,0,4,3,1
202501,21741,71,71,0,100,1,99
202409,13074,25,25,0,100,0,100
202409,10170,18,15,3,0,0,0
202409,12904,100,100,0,100,0,100
202409,11470,18,19,-1,5,0,5
202501,22822,30,30,0,0,0,0
202501,22465,80,79,1,100,13,87
202501,22517,24,24,0,0,0,0
202501,22463,75,75,0,100,50,50
202409,11327,33,32,1,100,0,100
202409,11653,22,18,4,0,0,0
202409,11993,30,28,2,100,0,100
202409,11349,60,26,34,60,0,60
202501,23454,18,11,7,0,0,0
202501,21422,16,11,5,5,0,5
202409,12089,60,60,0,25,0,25
202409,12353,5,1,4,5,0,5
202501,22138,5,1,4,5,0,5
202501,21012,85,33,52,100,0,100
202409,11494,15,14,1,0,0,0
202501,21365,35,33,2,100,0,100
202501,20992,30,30,0,0,0,0
202409,11630,10,3,7,10,0,10
202501,22175,5,0,5,5,0,5
202409,11175,45,36,9,100,0,100
202409,13739,22,21,1,100,0,100
202501,23628,30,30,0,10,10,0
202501,22677,50,50,0,100,13,87
202501,23133,15,11,4,100,0,100
202501,20766,80,80,0,10,5,5
202409,10934,60,49,11,10,0,10
202409,11614,20,11,9,100,0,100
202501,22174,5,1,4,5,0,5
202501,21237,60,59,1,60,2,58
202409,13005,40,41,-1,0,0,0
202409,11767,53,43,10,100,0,100
202501,22124,5,0,5,5,0,5
202501,21410,15,15,0,5,5,0
202409,13142,22,19,3,50,0,50
202501,21036,25,12,13,100,0,100
202501,20056,50,40,10,30,0,30
202409,12196,50,43,7,10,0,10
202501,23839,60,35,25,100,0,100
202409,13738,30,29,1,100,0,100
202409,12099,60,50,10,30,0,30
202409,12122,25,13,12,10,0,10
202409,10432,48,28,20,50,0,50
202501,22172,5,0,5,5,0,5
202409,12579,10,2,8,20,0,20
202409,11666,22,21,1,0,0,0
202409,11679,22,22,0,0,0,0
202501,22925,160,160,0,100,4,96
202501,22023,32,31,1,5,0,5
202501,22729,250,250,0,100,76,24
202501,23024,35,35,0,100,3,97
202409,13048,15,14,1,100,0,100
202409,13721,40,40,0,100,0,100
202409,12346,50,6,44,100,0,100
202409,10267,70,48,22,100,0,100
202501,21098,20,16,4,25,0,25
202409,12686,338,301,37,33,0,33
202409,11376,15,1,14,5,0,5
202501,21019,47,17,30,100,0,100
202409,10404,12,12,0,4,0,4
202501,22135,5,0,5,5,0,5
202409,12271,4,0,4,5,0,5
202409,11568,50,50,0,100,0,100
202501,23031,25,20,5,100,0,100
202409,12408,20,14,6,100,0,100
202501,22823,30,27,3,0,0,0
202501,22647,20,15,5,2,0,2
202501,22247,20,0,20,10,0,10
202501,20346,20,20,0,4,4,0
202501,21981,70,69,1,60,0,60
202501,22737,35,35,0,0,0,0
202409,10172,18,14,4,0,0,0
202501,23830,25,17,8,0,0,0
202501,20640,30,30,0,0,0,0
202409,12813,20,9,11,2,0,2
202409,11810,24,20,4,5,0,5
202409,11723,60,38,22,100,0,100
202409,10034,33,30,3,100,0,100
202501,20140,18,18,0,100,1,99
202501,21116,33,30,3,0,0,0
202409,12029,50,47,3,20,0,20
202409,12655,299,213,86,20,0,20
202501,22051,50,50,0,100,26,74
202501,22710,25,24,1,0,0,0
202409,10991,16,17,-1,3,0,3
202409,11024,3,3,0,50,0,50
202501,22253,5,0,5,5,0,5
202409,13690,35,21,14,100,0,100
202501,22624,20,20,0,2,0,2
202501,21223,33,33,0,100,10,90
202501,21384,40,32,8,100,0,100
202501,21601,22,22,0,0,0,0
202409,14118,15,0,15,0,0,0
202409,10386,20,19,1,4,0,4
202501,21108,100,41,59,100,0,100
202501,20075,25,15,10,20,0,20
202501,23042,50,50,0,20,0,20
202409,12026,50,35,15,20,0,20
202501,22292,3,0,3,3,0,3
202409,10259,15,0,15,100,0,100
202409,12733,22,20,2,0,0,0
202409,10983,16,15,1,3,0,3
202501,21547,22,21,1,0,0,0
202501,20341,20,20,0,4,2,2
202501,21791,20,0,20,0,0,0
202501,20997,30,30,0,0,0,0
202501,22736,35,35,0,0,0,0
202409,12984,95,89,6,10,0,10
202501,20986,55,29,26,100,0,100
202409,14262,2,2,0,0,0,0
202501,21584,22,17,5,0,0,0
202501,21760,40,36,4,100,0,100
202409,12760,30,16,14,100,0,100
202409,10626,100,58,42,80,0,80
202409,12178,151,93,58,30,0,30
202409,13013,38,35,3,0,0,0
202409,12936,100,100,0,100,0,100
202501,20996,75,50,25,100,0,100
202409,11695,22,22,0,0,0,0
202501,22144,5,1,4,5,0,5
202501,23938,20,0,20,0,0,0
202409,12758,30,11,19,100,0,100
202501,21568,22,14,8,0,0,0
202501,21405,16,6,10,5,0,5
202501,20704,20,20,0,0,0,0
202501,21574,22,22,0,0,0,0
202409,12850,100,97,3,100,0,100
202409,13268,12,11,1,100,0,100
202501,20527,18,4,14,15,0,15
202501,22963,38,38,0,50,7,43
202409,10233,32,31,1,100,0,100
202409,10956,18,15,3,3,0,3
202501,21925,80,76,4,40,0,40
202409,10728,30,29,1,0,0,0
202409,11777,53,35,18,100,0,100
202501,23494,20,10,10,0,0,0
202409,14263,1,1,0,0,0,0
202409,10163,30,29,1,100,0,100
202409,14028,5,1,4,3,0,3
202501,21839,20,2,18,100,0,100
202501,20974,30,30,0,0,0,0
202409,10516,16,12,4,4,0,4
202409,13988,10,2,8,100,0,100
202409,10784,55,55,0,0,0,0
202409,11664,176,169,7,100,0,100
202501,20370,18,15,3,4,0,4
202409,11310,3,3,0,3,0,3
202501,21697,75,44,31,0,0,0
202501,21550,22,22,0,0,0,0
202409,10194,13,5,8,0,0,0
202409,11674,110,106,4,100,0,100
202409,12370,5,2,3,5,0,5
202409,10482,350,252,98,100,0,100
202409,13769,60,62,-2,100,0,100
202501,22932,60,60,0,100,58,42
202501,23107,16,13,3,100,0,100
202501,22017,32,26,6,10,0,10
202409,12845,65,61,4,100,0,100
202501,21608,22,22,0,0,0,0
202409,11090,70,14,56,100,0,100
202409,11483,15,16,-1,5,0,5
202409,10335,22,22,0,2,0,2
202501,20215,32,32,0,100,11,89
202501,21251,40,40,0,40,20,20
202409,10290,24,24,0,4,0,4
202409,10739,31,29,2,0,0,0
202409,11989,55,43,12,100,0,100
202409,12698,24,22,2,0,0,0
202501,21479,30,30,0,50,6,44
202501,20763,5,3,2,10,0,10
202409,12731,22,22,0,0,0,0
202409,11076,31,27,4,0,0,0
202501,22777,25,25,0,30,20,10
202501,21056,33,31,2,0,0,0
202501,23768,10,4,6,100,0,100
202409,11680,132,127,5,100,0,100
202409,10677,31,31,0,0,0,0
202501,20156,30,29,1,100,3,97
202409,12108,60,52,8,30,0,30
202501,22642,20,17,3,2,0,2
202501,21216,33,33,0,100,15,85
202501,21458,24,17,7,5,0,5
202501,22110,180,99,81,100,0,100
202501,21112,75,75,0,0,0,0
202409,12067,55,52,3,12,0,12
202409,13160,38,33,5,50,0,50
202409,11770,50,41,9,100,0,100
202409,10819,50,43,7,10,0,10
202409,12390,3,0,3,3,0,3
202501,21992,100,27,73,0,0,0
202501,23739,60,60,0,100,18,82
202501,23577,77,66,11,0,0,0
202409,10169,30,21,9,5,0,5
202501,21391,35,33,2,0,0,0
202409,11788,50,42,8,100,0,100
202501,23155,50,50,0,100,3,97
202501,22848,60,19,41,50,0,50
202409,11524,60,46,14,50,0,50
202409,10811,23,18,5,0,0,0
202409,12429,5,1,4,5,0,5
202409,12090,60,59,1,25,0,25
202409,12695,24,23,1,0,0,0
202409,10894,60,22,38,100,0,100
202501,21194,210,210,0,20,15,5
202409,12911,35,35,0,0,0,0
202501,20860,100,64,36,50,0,50
202409,11966,38,22,16,100,0,100
202409,12653,180,180,0,50,0,50
202409,12045,200,179,21,100,0,100
202409,11554,24,22,2,5,0,5
202409,10948,32,33,-1,3,0,3
202409,12700,24,20,4,0,0,0
202409,12202,40,38,2,30,0,30
202409,12671,24,22,2,0,0,0
202409,11418,19,19,0,4,0,4
202409,12880,250,218,32,100,0,100
202409,12348,5,0,5,5,0,5
202501,23933,25,20,5,100,0,100
202409,13151,18,0,18,50,0,50
202409,13719,50,50,0,100,0,100
202501,23131,15,15,0,100,0,100
202409,12372,5,2,3,5,0,5
202409,10831,6,5,1,10,0,10
202409,13592,20,10,10,100,0,100
202501,20082,22,5,17,10,0,10
202409,12159,84,82,2,50,0,50
202409,12897,25,25,0,0,0,0
202409,11303,4,4,0,3,0,3
202501,22831,45,45,0,40,25,15
202409,12747,10,11,-1,0,0,0
202409,11819,53,47,6,5,0,5
202409,13895,20,24,-4,10,0,10
202409,10302,24,24,0,4,0,4
202501,22153,5,1,4,5,0,5
202501,22627,20,14,6,2,0,2
202409,10642,64,65,-1,10,0,10
202409,11650,80,74,6,100,0,100
202409,13306,12,13,-1,100,0,100
202409,13302,15,10,5,100,0,100
202409,10343,22,21,1,2,0,2
202501,20891,20,7,13,3,0,3
202409,12021,50,26,24,12,0,12
202409,11084,60,24,36,0,0,0
202501,20927,65,24,41,50,0,50
202501,20454,358,336,22,100,0,100
202409,12815,22,19,3,2,0,2
202501,22632,140,131,9,100,0,100
202501,20028,45,45,0,100,12,88
202409,11774,50,47,3,100,0,100
202409,13755,25,20,5,100,0,100
202501,20538,18,18,0,3,0,3
202409,11678,22,21,1,0,0,0
202501,20220,32,32,0,100,6,94
202501,20815,30,29,1,100,0,100
202501,20398,50,18,32,10,0,10
202501,20641,30,30,0,0,0,0
